FIPS_Code,County,State,Total,Male,Female,Under18,a18to64,over65,oneRace,White,AfricanAmerican,Native,Asian,Hawaiian,otherRace,Multiracial,FamilyHousehold,OtherLivingArrangements,totPoverty25,NoHS,HighSchool,SomeCollege,Bachelors,AmericanBorn,ForeignBorn,NaturalizedCitizen,Disability,NoDisability,totPoverty16to64,FullTime,PartTime,NoWork,Year
1073,Jefferson County, Alabama,645466,303504,341962,152206,409543,83717,640703,345486,273684,1337,9210,0,10986,4763,531414,114052,433397,57382,119244,130996,125775,617471,27995,8242,96449,548185,427877,199579,111711,116587,2010
4013,Maricopa County, Arizona,3778090,1866272,1911818,994991,2325410,457689,3678160,3064177,192854,66300,128263,7466,219100,99930,3153314,624776,2416172,329078,584404,814490,688200,3213803,564287,192942,362868,3410305,2434102,1156912,635787,641403,2010
4019,Pima County, Arizona,956111,469386,486725,220278,584879,150954,930675,772745,32087,31039,25158,1047,68599,25436,768384,187727,641539,82006,145700,219891,193942,833353,122758,53172,120151,832004,612018,263430,179633,168955,2010
6001,Alameda County, California,1488413,728682,759731,336700,986078,165635,1406431,682129,181089,7669,394746,12006,128792,81982,1224529,263884,1011634,142360,200001,258667,410606,1028421,459992,235212,130289,1357047,1023365,464125,286245,272995,2010
6013,Contra Costa County, California,1041847,507068,534779,259678,653589,128580,991150,668945,95215,3947,153814,4913,64316,50697,907304,134543,698088,77763,134515,214464,271346,794840,247007,125766,97631,943676,685215,303746,210748,170721,2010
6019,Fresno County, California,917306,454619,462687,274931,551278,91097,878243,544217,44933,8341,87736,1121,191895,39063,813803,103503,537326,138663,120666,169004,108993,714598,202708,67610,99240,817757,584773,220631,178463,185679,2010
6029,Kern County, California,809688,406758,402930,251900,483845,73943,777201,582354,40837,9876,31916,525,111693,32487,724637,85051,469652,130159,119760,146024,73709,641171,168517,50570,98621,709858,514458,195229,152074,167155,2010
6037,Los Angeles County, California,9678817,4764325,4914492,2367269,6270393,1041155,9319465,5105623,809080,40644,1340907,23215,1999996,359352,8220264,1458553,6300888,1519969,1280803,1649518,1850598,6210890,3467927,1588054,901935,8772382,6567327,2886118,1784602,1896607,2010
6059,Orange County, California,2979771,1470125,1509646,721707,1911186,346878,2889074,1824356,48005,11370,540050,10398,454895,90697,2587381,392390,1962998,328378,348855,566324,719441,2067515,912256,456859,219092,2758718,2001482,931974,548609,520899,2010
6065,Riverside County, California,2171404,1074222,1097182,614305,1299395,257704,2079568,1467383,130433,20353,130978,7900,322521,91836,1928767,242637,1332557,279726,334062,446133,272636,1682558,488846,205885,219515,1948246,1375547,543898,398751,432898,2010
6067,Sacramento County, California,1391431,674507,716924,355344,880160,155927,1301868,844648,134577,13676,201529,13812,93626,89563,1154661,236770,897000,131441,190727,327822,247010,1119848,271583,140605,185123,1205411,920698,378157,270762,271779,2010
6071,San Bernardino County, California,1998123,983750,1014373,583275,1235051,179797,1909121,1285741,171781,19400,127643,6275,298281,89002,1800836,197287,1196496,268581,310113,392562,225240,1561341,436782,176710,212989,1779956,1310086,526360,344284,439442,2010
6073,San Diego County, California,3011428,1490665,1520763,713892,1952658,344878,2870071,2158870,146036,17610,327147,12490,207918,141357,2477328,534100,1981363,291368,376600,639504,673891,2292059,719369,329807,273369,2698730,2037681,927064,546438,564179,2010
6075,San Francisco County, California,798847,404494,394353,105667,584455,108725,769945,411386,48622,3911,267317,3465,35244,28902,516975,281872,617463,86563,87312,128639,314949,514625,284222,170611,84929,713918,596188,303324,165030,127834,2010
6077,San Joaquin County, California,669544,329650,339894,197732,403377,68435,627059,408635,46050,9812,96967,3238,62357,42485,593745,75799,404092,94618,102559,133957,72958,516217,153327,65176,76697,592660,427366,165041,135100,127225,2010
6081,San Mateo County, California,713491,350482,363009,158166,460632,94693,676315,420486,17214,3406,178076,10988,46145,37176,599674,113817,500279,58926,85252,139807,216294,460971,252520,135958,55208,658145,478104,243289,132925,101890,2010
6085,Santa Clara County, California,1766692,885681,881011,426257,1145200,195235,1690464,882328,45584,9723,570257,6505,176067,76228,1522372,244320,1191434,160747,189162,291077,550448,1107737,658955,341640,141252,1625253,1189769,555849,332319,301601,2010
6099,Stanislaus County, California,509261,251812,257449,144750,311689,52822,484799,398003,13403,5140,24551,3518,40184,24462,459185,50076,310647,74523,88591,97318,50215,406553,102708,42112,62863,446136,328645,124265,100798,103582,2010
6111,Ventura County, California,813891,403716,410175,208211,510671,95009,784771,610852,13530,6319,57218,1168,95684,29120,710583,103308,527126,94125,98903,170919,163179,625130,188761,80681,77076,734492,537057,248326,166750,121981,2010
8005,Arapahoe County, Colorado,569816,279342,290474,146323,367041,56452,545219,424670,54078,6324,29020,978,30149,24597,475836,93980,375322,32370,82218,121263,139471,480285,89531,34005,50014,518149,384333,198915,112311,73107,2010
8031,Denver County, Colorado,592734,294782,297952,127702,403803,61229,573989,414161,58650,7015,18871,321,74971,18745,414340,178394,405613,64723,79487,94308,167095,495686,97048,30061,58132,533950,414809,205199,124545,85065,2010
8041,El Paso County, Colorado,609625,300741,308884,161414,386826,61385,573535,496243,36053,4044,13828,1293,22074,36090,513018,96607,390883,27397,85380,143546,134560,566146,43479,20218,65460,529063,404643,194633,118417,91593,2010
9001,Fairfield County, Connecticut,897928,438096,459832,224881,554452,118595,880834,683886,95908,611,40885,172,59372,17094,767049,130879,609278,72364,139265,127162,270487,714346,183582,76968,80510,817418,580148,279563,170199,130386,2010
9003,Hartford County, Connecticut,869216,416238,452978,202137,542531,124548,844669,636599,111135,1352,36642,465,58476,24547,711649,157567,597588,71019,164042,154404,208123,740079,129137,66949,100291,768682,567098,280766,169054,117278,2010
9009,New Haven County, Connecticut,837756,404106,433650,190158,530601,116997,814711,631075,105219,851,28597,264,48705,23045,687847,149909,573999,66543,177391,145395,184670,737764,99992,46946,96479,740714,555588,266170,171830,117588,2010
10003,New Castle County, Delaware,523087,251741,271346,122879,335402,64806,510647,351827,122518,1231,23263,685,11123,12440,435852,87235,348466,36356,102154,92855,117101,471007,52080,23518,57999,464819,349334,179282,91876,78176,2010
11001,District of Columbia, District of Columbia,570953,267612,303341,100353,403628,66972,559507,224091,297061,1927,19905,233,16290,11446,356523,214430,408792,50047,82001,69558,207186,491605,79348,31786,65529,504096,415697,220061,101769,93867,2010
12009,Brevard County, Florida,534329,260499,273830,105330,320943,108056,521697,447701,53169,2290,10664,55,7818,12632,437918,96411,388804,34044,128490,128016,98254,486456,47873,28375,78076,454529,336002,151515,87897,96590,2010
12011,Broward County, Florida,1739280,841341,897939,386587,1105665,247028,1694941,1112555,461586,5597,57620,1625,55958,44339,1422978,316302,1206266,153137,342061,356482,354586,1183041,556239,283243,194052,1543723,1153679,551382,320844,281453,2010
12031,Duval County, Florida,843733,406035,437698,201408,548357,93968,820554,522491,251156,1872,34536,252,10247,23179,692008,151725,564970,67333,164321,190926,142390,765155,78578,42813,97953,737605,571646,274468,144932,152246,2010
12057,Hillsborough County, Florida,1216607,592535,624072,291860,782659,142088,1183676,887419,203439,13631,42682,582,35923,32931,988542,228065,802910,110437,223234,237251,231988,1023847,192760,84966,134194,1078901,816087,391203,202395,222489,2010
12071,Lee County, Florida,613103,301727,311376,119194,350117,143792,603465,514635,51477,1501,8786,51,27015,9638,499250,113853,449418,63248,143792,137153,105225,518087,95016,33659,81832,531271,364293,148081,97216,118996,2010
12086,Miami-Dade County, Florida,2447254,1167872,1279382,540671,1556908,349675,2418828,1837173,449070,4290,38819,110,89366,28426,2104234,343020,1673504,376279,466422,400745,430058,1160417,1286837,637612,256664,2189008,1623652,768452,355366,499834,2010
12095,Orange County, Florida,1126295,553120,573175,264085,757223,104987,1089011,757296,227806,3901,50113,2057,47838,37284,930156,196139,720579,90735,192205,218430,219209,917097,209198,100454,106093,1019565,788129,365211,226728,196190,2010
12099,Palm Beach County, Florida,1308349,631453,676896,266229,760852,281268,1287713,1002221,223611,1730,31444,822,27885,20636,1043404,264945,940361,119025,250582,270829,299925,1003934,304415,136793,148553,1158817,794137,377795,216355,199987,2010
12103,Pinellas County, Florida,901959,432649,469310,160146,552759,189054,884364,755541,91580,1960,27456,770,7057,17595,674317,227642,676630,79797,203005,206208,187620,795650,106309,57563,128995,771745,573243,275326,148821,149096,2010
12105,Polk County, Florida,588527,286546,301981,139426,343320,105781,578722,464996,84247,2085,10309,238,16847,9805,504208,84319,397874,71495,143068,110838,72473,524799,63728,24201,85371,502455,359393,158429,93759,107205,2010
12127,Volusia County, Florida,479516,232490,247026,91221,285893,102402,470354,389514,49046,1195,7254,90,23255,9162,389688,89828,351072,44361,111718,121044,73949,445840,33676,18423,70297,409068,296732,127976,71913,96843,2010
13067,Cobb County, Georgia,684334,331347,352987,176383,449133,58818,671332,427072,171438,1543,32368,317,38594,13002,579780,104554,447286,41976,83065,119584,202661,582389,101945,37559,50042,633481,468509,235552,128216,104741,2010
13089,DeKalb County, Georgia,680289,325595,354694,163207,456014,61068,670140,242541,370910,960,34445,106,21178,10149,543114,137175,451613,52177,99836,128455,171145,564602,115687,38101,66433,613369,473253,225929,122977,124347,2010
13121,Fulton County, Georgia,894461,433710,460751,218174,593921,82366,877993,405146,394439,1527,49951,235,26695,16468,696279,198182,601113,57324,117800,145958,280031,777854,116607,37494,79519,814313,618680,299997,163112,155571,2010
13135,Gwinnett County, Georgia,802317,394559,407758,232237,515649,54431,783670,431331,188191,1492,86629,392,75635,18647,718067,84250,501683,62674,118999,148256,171754,597900,204417,77200,53961,747791,541599,267867,142303,131429,2010
15003,Honolulu County, Hawaii,926014,457904,468110,206977,582112,136925,722162,187715,16367,1557,418571,90060,7892,203852,788173,137841,634813,62666,170241,197487,204419,734199,191815,111720,89872,812717,605608,329586,149262,126760,2010
17031,Cook County, Illinois,5128124,2479861,2648263,1219242,3304907,603975,5035513,2896326,1259992,13614,323636,1093,540852,92611,4189044,939080,3417487,541117,835451,874268,1166651,4041346,1086778,478648,506968,4620147,3448313,1589973,935701,922639,2010
17043,DuPage County, Illinois,904659,444571,460088,226777,577333,100549,887291,727577,40891,2160,92386,215,24062,17368,786547,118112,605612,49322,118752,158350,279188,734138,170521,81709,69134,835406,604665,311782,176820,116063,2010
17089,Kane County, Illinois,510403,254114,256289,147480,313256,49667,500783,384959,28597,553,17014,0,69660,9620,457663,52740,320794,52415,76712,89829,101838,416623,93780,31398,37618,472608,329966,158720,98287,72959,2010
17097,Lake County, Illinois,693785,344914,348871,190791,431728,71266,676075,527786,45695,2750,42630,137,57077,17710,619701,74084,445227,47851,97133,113850,186393,567562,126223,56899,51707,641092,455618,220473,136355,98790,2010
17197,Will County, Illinois,669930,331992,337938,195958,412140,61832,653156,516256,71529,1465,30588,687,32631,16774,604673,65257,421798,37104,118333,134870,131491,590548,79382,38980,51455,618338,434873,212884,123264,98725,2010
18097,Marion County, Indiana,887242,427850,459392,220322,575163,91757,863212,571809,236422,2710,19186,0,33085,24030,702754,184488,577843,90473,171829,160754,154787,806675,80567,19828,110273,776763,599612,266759,187519,145334,2010
21111,Jefferson County, Kentucky,731341,352428,378913,168299,465956,97086,716287,542158,150070,1292,16695,184,5888,15054,583586,147755,497491,61930,136860,146490,152211,683510,47831,18692,110316,619701,483334,227749,140405,115180,2010
24005,Baltimore County, Maryland,782986,370343,412643,172083,496882,114021,766706,510098,201735,1754,40222,74,12823,16280,649699,133287,539618,51794,145246,148743,193835,695937,87049,39704,88049,693193,516078,285937,126650,103491,2010
24031,Montgomery County, Maryland,969114,465436,503678,231901,619653,117560,930312,553220,166335,3193,133774,63,73727,38802,821635,147479,665037,62738,95347,130416,376536,655657,313457,144694,68860,897050,646574,357013,182934,106627,2010
24033,Prince George's County, Maryland,839358,402369,436989,200350,560472,78536,818108,185916,546361,2159,33568,163,49941,21250,703137,136221,552329,74714,155448,158868,163299,669602,169756,63294,67803,767669,585127,327658,145501,111968,2010
24510,Baltimore city, Maryland,602129,281153,320976,129275,402406,70448,587441,183588,380331,2389,13920,122,7091,14688,458922,143207,402014,91835,117411,93871,98897,559075,43054,16858,91766,509936,417574,184284,103377,129913,2010
25005,Bristol County, Massachusetts,533757,258399,275358,119793,340293,73671,522617,478876,18599,1298,9860,76,13908,11140,443816,89941,367655,68294,109804,95653,93904,475858,57899,38674,74437,459196,354942,162274,111950,80718,2010
25009,Essex County, Massachusetts,730794,350669,380125,170570,459748,100476,715161,600454,23650,894,23831,0,66332,15633,606476,124318,500071,53241,128541,132290,185999,618091,112703,57973,75685,654683,481057,234385,147253,99419,2010
25017,Middlesex County, Massachusetts,1456586,708099,748487,318407,950199,187980,1417790,1182019,65435,2004,134055,229,34048,38796,1172210,284376,1024368,80961,228645,199246,515516,1172872,283714,126219,124200,1331085,987495,518159,295595,173741,2010
25025,Suffolk County, Massachusetts,686271,331987,354284,123794,489813,72664,638201,376116,156143,1558,56197,133,48054,48070,466067,220204,461776,71945,118131,84382,187318,489560,196711,80989,78067,608100,503718,232574,155945,115199,2010
25027,Worcester County, Massachusetts,772639,378782,393857,184474,490896,97269,753796,676024,29174,1454,30731,301,16112,18843,643570,129069,524884,58951,148970,143062,173901,686743,85896,42772,89518,682663,513265,247986,156943,108336,2010
26081,Kent County, Michigan,591840,290398,301442,155820,370976,65044,574895,489969,57241,3033,13676,0,10976,16945,490237,101603,377808,41444,105180,116259,114925,552743,39097,16499,62337,529371,388736,173091,124218,91427,2010
26099,Macomb County, Michigan,833385,404798,428587,191861,524560,116964,817024,709938,73088,2641,25739,195,5423,16361,708506,124879,571514,67457,180314,193582,130161,744803,88582,48662,105654,726997,548188,235220,164456,148512,2010
26125,Oakland County, Michigan,1191848,578801,613047,278436,757697,155715,1163161,926155,159251,2658,67988,470,6639,28687,988840,203008,824097,59123,166399,254006,344569,1063593,128255,64539,134788,1056799,792179,369434,230538,192207,2010
26163,Wayne County, Michigan,1797778,863261,934517,452890,1120023,224865,1756317,941935,726989,6231,45645,246,35271,41461,1494849,302929,1170030,182248,361479,380028,246275,1660305,137473,71793,289765,1507696,1181465,418811,317146,445508,2010
27053,Hennepin County, Minnesota,1133365,556668,576697,257384,750489,125492,1094607,865162,130510,8456,70351,447,19681,38758,853448,279917,771490,59755,147266,220282,344187,985746,147619,59546,105678,1027421,779086,393274,242110,143702,2010
27123,Ramsey County, Minnesota,495884,240765,255119,116939,320026,58919,478235,356353,55686,2927,57761,247,5261,17649,385282,110602,327010,33738,79521,90136,123615,427613,68271,29469,57348,438430,334261,155636,108627,69998,2010
29095,Jackson County, Missouri,666964,322603,344361,163102,422781,81081,644089,444870,160057,2164,11138,1582,24278,22875,532144,134820,442594,57067,127684,137818,120025,628373,38591,15401,81266,585562,440712,221564,120329,98819,2010
29189,St. Louis County, Missouri,982030,465267,516763,231206,608980,141844,960365,693503,227557,2709,32549,65,3982,21665,807548,174482,668797,54776,154364,189998,269659,912452,69578,35174,109799,870882,639576,326794,182784,129998,2010
31055,Douglas County, Nebraska,505528,246936,258592,129966,323880,51682,488908,406001,55564,3714,11191,605,11833,16620,404665,100863,325174,31819,71139,102696,119520,461963,43565,17536,56790,448463,337188,180726,100906,55556,2010
32003,Clark County, Nevada,1932015,969989,962026,483476,1228829,219710,1853264,1314505,197635,9100,169870,14309,147845,78751,1596284,335731,1273223,203333,379237,412759,277894,1510435,421580,176586,191102,1733656,1285111,605852,342286,336973,2010
34003,Bergen County, New Jersey,896810,432102,464708,203142,560586,133082,879777,659028,48856,1925,130461,0,39507,17033,783606,113204,628350,51319,167092,129592,280347,638547,258263,146935,73534,823224,585572,312514,135609,137449,2010
34007,Camden County, New Jersey,505852,243248,262604,124072,319080,62700,489482,321014,94706,2228,25768,34,45732,16370,427801,78051,336355,42789,107413,88751,97402,453612,52240,27614,63001,442391,334240,161827,94023,78390,2010
34013,Essex County, New Jersey,761612,361164,400448,189544,485368,86700,722497,332893,306906,2659,35795,40,44204,39115,635098,126514,502955,82180,142395,113407,164973,570010,191602,87203,71947,689418,506050,244403,120921,140726,2010
34017,Hudson County, New Jersey,629505,310900,318605,129616,435242,64647,608524,322788,81838,1336,84530,0,118032,20981,503424,126081,438025,79956,116452,82789,158828,366249,263256,114492,57960,571466,451213,232106,99360,119747,2010
34023,Middlesex County, New Jersey,786181,384520,401661,182948,505820,97413,765303,502055,69887,1478,169926,173,21784,20878,684489,101692,536571,60705,143406,113612,218848,545868,240313,120069,63216,722870,527536,273375,129240,124921,2010
34029,Ocean County, New Jersey,570719,272147,298572,132698,318672,119349,559624,519867,15821,106,8832,321,14677,11095,484617,86102,396728,37484,154211,106570,98463,526277,44442,23967,74850,495003,333281,144692,110135,78454,2010
34031,Passaic County, New Jersey,493423,240537,252886,124072,311598,57753,483753,334027,59090,1385,26030,0,63221,9670,433078,60345,321486,54115,110615,69850,86906,351153,142270,62130,49066,444357,326211,157188,76086,92937,2010
34039,Union County, New Jersey,529835,256248,273587,129350,335240,65245,520303,315712,112020,549,23223,599,68200,9532,464912,64923,356095,56405,104710,81731,113249,366082,163753,76713,43778,486013,349804,181310,86688,81806,2010
35001,Bernalillo County, New Mexico,658847,322166,336681,156589,421755,80503,632590,466001,19075,29025,14869,57,103563,26257,529324,129523,434844,56629,100765,139921,137529,584937,73910,25491,73593,582984,438587,219385,113318,105884,2010
36005,Bronx County, New York,1351398,628207,723191,362091,851279,138028,1296258,305977,470872,7474,46821,190,464924,55140,1152611,198787,836642,253332,242182,197849,143279,880716,470682,204469,181196,1169304,895469,375215,200600,319654,2010
36029,Erie County, New York,892574,430795,461779,195675,560238,136661,872830,718530,114757,5638,21578,104,12223,19744,702065,190509,611781,60461,181123,184427,185770,833380,59194,33503,114910,777456,586031,270679,176758,138594,2010
36047,Kings County, New York,2484504,1170743,1313761,584523,1618390,281591,2435199,1118682,843525,11441,262268,1215,198068,49305,2043184,441320,1637767,351078,474723,340650,471316,1541710,942794,516128,226785,2255515,1687198,780033,365586,541579,2010
36055,Monroe County, New York,718286,345131,373155,165453,453232,99601,702941,551611,107292,2188,24124,124,17602,15345,573962,144324,485983,53628,118525,136973,176857,652959,65327,40514,84508,633565,474291,220026,140968,113297,2010
36059,Nassau County, New York,1319454,639026,680428,307418,813531,198505,1285447,951060,142544,1578,105023,50,85192,34007,1186881,132573,908309,94130,224144,211687,378348,1035918,283536,165034,115019,1204229,853249,442883,213082,197284,2010
36061,New York County, New York,1550475,726145,824330,231425,1108267,210783,1485738,892783,240334,4697,172274,469,175181,64737,972617,577858,1160957,163889,150209,167452,679407,1102899,447576,206378,147518,1402079,1134718,583402,285485,265831,2010
36081,Queens County, New York,2213118,1072842,1140276,454515,1480156,278447,2140828,929229,405349,8212,517698,2009,278331,72290,1891452,321666,1541547,300237,422944,362010,456356,1151304,1061814,562909,206550,2006019,1534958,747448,361923,425587,2010
36103,Suffolk County, New York,1471909,724044,747865,352873,923167,195869,1442947,1195114,108517,3479,46651,124,89062,28962,1308500,163409,998417,98526,304794,270271,324826,1260950,210959,103591,126839,1344559,968773,492753,251634,224386,2010
36119,Westchester County, New York,926374,445236,481138,225162,568356,132856,894344,618124,126462,1096,50560,0,98102,32030,797599,128775,633754,75639,140105,133114,284896,689327,237047,109598,77225,849080,595234,301759,160414,133061,2010
37119,Mecklenburg County, North Carolina,908026,439570,468456,230011,597021,80994,886682,528024,278640,4255,42261,152,33350,21344,728220,179806,597273,72349,120011,169267,235646,786213,121813,35863,77017,830219,619397,308934,174197,136266,2010
37183,Wake County, North Carolina,884085,431404,452681,232636,576087,75362,863681,610214,178912,2659,47927,112,23857,20404,726285,157800,577894,41135,96961,168034,271764,765863,118222,39825,67394,815953,600339,314284,161041,125014,2010
39035,Cuyahoga County, Ohio,1250764,594470,656294,283654,777741,189369,1221666,805970,369373,3202,31692,49,11380,29098,990974,259790,862950,105260,249352,254647,253691,1158648,92116,54519,178388,1072214,813177,374098,233535,205544,2010
39049,Franklin County, Ohio,1144399,556776,587623,275650,755631,113118,1111843,799868,246638,1990,45450,304,17593,32556,881461,262938,743148,77035,199387,206621,260105,1033433,110966,40789,133610,1010326,784864,387762,227693,169409,2010
39061,Hamilton County, Ohio,781880,372908,408972,184871,493609,103400,764075,541508,198993,1952,15439,0,6183,17805,625520,156360,518209,54182,142798,147148,174081,739498,42382,18159,93645,687934,513851,239175,153093,121583,2010
39113,Montgomery County, Ohio,522244,250310,271934,120778,322341,79125,508522,385229,108448,769,9343,0,4733,13722,417039,105205,356242,42325,109185,121830,82902,503222,19022,8282,80989,439745,336838,149305,97782,89751,2010
39153,Summit County, Ohio,532666,256559,276107,121686,333971,77009,518139,432796,72317,278,11013,0,1735,14527,430458,102208,363222,37338,115713,100584,109587,509647,23019,11814,68606,463636,348544,165121,100142,83281,2010
40109,Oklahoma County, Oklahoma,707527,346600,360927,179405,443821,84301,658962,478211,107558,18564,22264,747,31618,48565,575756,131771,457958,65140,118313,143878,130627,633567,73960,21860,96426,608023,461567,233690,124391,103486,2010
40143,Tulsa County, Oklahoma,595151,290831,304320,152305,371820,71026,557295,430102,63006,29948,14494,403,19342,37856,488712,106439,388169,45462,103335,128789,110583,548852,46299,13956,80691,513812,388235,194048,106985,87202,2010
41051,Multnomah County, Oregon,723067,356061,367006,149182,499210,74675,697513,564046,43792,6211,49168,3751,30545,25554,525910,197157,507706,56294,102935,154491,193986,619500,103567,42465,84676,637906,515785,222985,169441,123359,2010
41067,Washington County, Oregon,525180,258718,266462,134469,338830,51881,503089,401723,9073,4627,44933,2069,40664,22091,443171,82009,348626,32206,63910,115457,137053,438365,86815,33162,49865,475039,353064,168350,106328,78386,2010
42003,Allegheny County, Pennsylvania,1182595,564342,618253,236466,748650,197479,1156010,969538,149262,1454,32029,459,3268,26585,911037,271558,843821,58902,268668,215800,300451,1127368,55227,25571,153929,1027940,779188,392061,223384,163743,2010
42045,Delaware County, Pennsylvania,539763,258821,280942,128731,334183,76849,529360,396085,105776,116,24641,0,2742,10403,451690,88073,364343,29970,117654,88489,128230,485454,54309,27597,58876,480704,350860,175682,97773,77405,2010
42071,Lancaster County, Pennsylvania,506274,248720,257554,126911,304120,75243,498294,458050,18715,1487,9850,98,10094,7980,435383,70891,334751,52099,128433,72712,81507,482290,23984,12644,55355,450701,318412,163505,89489,65418,2010
42101,Philadelphia County, Pennsylvania,1487471,697595,789876,338982,968359,180130,1451165,614364,653901,4468,95023,224,83185,36306,1137809,349662,965896,190694,348136,206959,220107,1313215,174256,83034,228466,1258633,1010216,399846,255204,355166,2010
44007,Providence County, Rhode Island,596396,287466,308930,136064,380671,79661,575852,438275,51829,1427,19792,426,64103,20544,472139,124257,403454,82152,113363,103819,104120,489794,106602,48429,92641,503051,398587,177153,116922,104512,2010
47037,Davidson County, Tennessee,602785,289023,313762,133904,403698,65183,587482,379339,163641,1237,17213,0,26052,15303,459633,143152,410354,63165,98896,104606,143687,529225,73560,22555,68972,533553,416955,196723,130883,89349,2010
47157,Shelby County, Tennessee,908278,428247,480031,239263,575428,93587,894883,373473,473631,2320,21912,44,23503,13395,772016,136262,581486,75601,163600,176082,166203,849864,58414,21065,111633,795946,604106,287558,150663,165885,2010
48029,Bexar County, Texas,1682820,819678,863142,460514,1050968,171338,1640726,1276920,119189,15767,39438,2259,187153,42094,1446125,236695,1048404,184176,260212,331081,272935,1453623,229197,85489,215715,1453637,1103934,549407,271950,282577,2010
48085,Collin County, Texas,784810,385643,399167,224837,500422,59551,761336,582329,63760,4590,88990,271,21396,23474,693644,91166,503052,33522,82722,145678,241130,647167,137643,66478,45253,739230,524639,294746,124753,105140,2010
48113,Dallas County, Texas,2338299,1151622,1186677,650210,1487924,200165,2280843,1327676,511907,10129,118505,921,311705,57456,1965792,372507,1459949,331028,341221,372870,414830,1783202,555097,139417,213965,2123481,1555226,800413,372434,382379,2010
48121,Denton County, Texas,653031,321381,331650,181892,425672,45467,628022,518907,49301,2819,43439,764,12792,25009,558161,94870,409431,31581,74023,139588,164239,563486,89545,35478,51799,600600,444589,249402,119853,75334,2010
48141,El Paso County, Texas,793252,381346,411906,240628,470924,81700,777087,626255,23283,4532,7595,137,115285,16165,720829,72423,466290,126326,112559,135029,92376,585357,207895,88721,94704,689365,498405,212422,130462,155521,2010
48157,Fort Bend County, Texas,583131,283691,299440,174112,366456,42563,572094,316775,126331,1563,101213,0,26212,11037,543919,39212,364035,41714,71902,110066,140353,439402,143729,72746,39516,543398,387110,207756,82230,97124,2010
48201,Harris County, Texas,4069948,2022490,2047458,1136324,2604620,329004,4001694,2541165,764401,20818,254865,2615,417830,68254,3496561,573387,2525541,551938,589223,678136,706244,3031934,1038014,322671,355605,3713121,2729716,1352468,684164,693084,2010
48215,Hidalgo County, Texas,773729,376355,397374,266873,434890,71966,767125,670270,3989,3145,8501,0,81220,6604,726635,47094,423445,160661,103651,91990,67143,550459,223270,59936,104014,668980,464399,183014,128726,152659,2010
48439,Tarrant County, Texas,1792250,875711,916539,506252,1129213,156785,1749110,1231669,263876,8572,83816,845,160332,43140,1548474,243776,1120268,177835,269838,349833,322762,1510047,282203,97383,178141,1612473,1185370,622074,301876,261420,2010
48453,Travis County, Texas,1012212,510108,502104,244073,694758,73381,985404,733688,83387,5313,59440,634,102942,26808,767156,245056,649550,87251,114160,166900,281239,833761,178451,44208,87949,923722,718250,365781,206165,146304,2010
49035,Salt Lake County, Utah,1017549,508251,509298,295806,633394,88349,991642,876093,15839,8293,32198,16060,43159,25907,882310,135239,614133,71677,150598,212333,179525,896140,121409,44461,83075,933688,662236,321776,204700,135760,2010
49049,Utah County, Utah,507335,253302,254033,178617,295193,33525,493920,459994,2686,3617,6007,4112,17504,13415,451107,56228,253346,15401,45873,101627,90445,471335,36000,10116,37321,469783,309352,120506,121963,66883,2010
51059,Fairfax County, Virginia,1075696,531691,544005,260607,710433,104656,1039338,679022,98887,6175,192750,795,61709,36358,921758,153938,736281,61462,107932,152223,414664,748600,327096,156584,64682,1000481,740253,433799,176132,130322,2010
53033,King County, Washington,1905324,949426,955898,408006,1291615,205703,1814393,1332417,114336,16017,283300,14375,53948,90931,1468993,436331,1333637,104870,232763,388507,607497,1513994,391330,190051,174519,1728541,1338749,660950,400427,277372,2010
53053,Pierce County, Washington,778152,382980,395172,195054,498948,84150,727155,589029,54173,7263,44928,11289,20473,50997,649902,128250,510446,50115,146581,192779,120971,698805,79347,43104,92766,671454,520928,245235,147418,128275,2010
53061,Snohomish County, Washington,703739,349184,354555,170721,461358,71660,672732,566513,16011,9777,63082,2937,14412,31007,590627,113112,471253,44830,113924,176451,136048,600698,103041,48530,76799,624496,482576,227646,149698,105232,2010
55079,Milwaukee County, Wisconsin,927295,446243,481052,230557,590665,106073,893623,571549,243417,4807,31939,405,41506,33672,713924,213371,597236,85883,175531,171491,164331,850110,77185,30457,113345,813832,617476,278627,187591,151258,2010
1073,Jefferson County, Alabama,644715,302836,341879,152518,408158,84039,640705,337784,273777,1669,10214,0,17261,4010,534904,109811,434510,57078,112622,134847,129963,615499,29216,7548,90912,553437,424712,194980,110279,119453,2011
4013,Maricopa County, Arizona,3825655,1889318,1936337,990529,2358027,477099,3722088,3118035,189111,70877,131990,7802,204273,103567,3185222,640433,2466544,335846,565906,832838,731954,3249083,576572,201665,380200,3442481,2470393,1205372,613345,651676,2011
4019,Pima County, Arizona,966730,472999,493731,219500,592939,154291,938922,774194,35403,30263,26363,1528,71171,27808,779411,187319,647594,80053,149582,227380,190579,839801,126929,58643,134125,828784,619447,259438,175055,184954,2011
6001,Alameda County, California,1502661,737237,765424,335847,996246,170568,1419982,699491,185448,6333,399741,12915,116054,82679,1236760,265901,1029512,141881,203992,257145,426494,1036857,465804,238622,137915,1364163,1033770,469224,294514,270032,2011
6013,Contra Costa County, California,1057449,516102,541347,257745,666259,133445,999084,675161,95532,6079,149552,4960,67800,58365,913143,144306,712124,80944,139180,213235,278765,812918,244531,121119,107173,949547,695663,304706,206445,184512,2011
6019,Fresno County, California,925726,458907,466819,274009,557362,94355,889278,514641,43608,9455,89873,1815,229886,36448,818124,107602,546062,149421,127830,165427,103384,714336,211390,76964,107270,818041,591833,218757,175105,197971,2011
6029,Kern County, California,819955,410369,409586,251666,492158,76131,792083,620966,44717,11375,35620,953,78452,27872,736978,82977,476405,125849,126046,150948,73562,650670,169285,55636,95090,722278,520936,205004,146910,169022,2011
6037,Los Angeles County, California,9736878,4798069,4938809,2347654,6317061,1072163,9375630,5289451,805892,44855,1339441,27186,1868805,361248,8257487,1479391,6382113,1508423,1319642,1676114,1877934,6292434,3444444,1616598,925703,8808167,6608109,2892524,1775236,1940349,2011
6059,Orange County, California,3018660,1496171,1522489,726194,1933967,358499,2925109,1920663,50696,11414,553111,8883,380342,93551,2608650,410010,1996479,318376,363446,580118,734539,2087703,930957,465361,231340,2785283,2023992,950194,553948,519850,2011
6065,Riverside County, California,2201878,1091241,1110637,612257,1324237,265384,2123462,1469792,138245,23840,132250,6925,352410,78416,1957720,244158,1362868,275691,352676,454534,279967,1719167,482711,216110,234927,1962882,1398632,560716,384134,453782,2011
6067,Sacramento County, California,1411759,686523,725236,355268,895379,161112,1319456,848794,137030,12723,205428,13963,101518,92303,1165777,245982,915887,125967,200234,333897,255789,1123237,288522,153580,178798,1231767,934405,388879,272338,273188,2011
6071,San Bernardino County, California,2018391,993022,1025369,581527,1252163,184701,1927436,1264064,160431,17066,130820,6553,348502,90955,1816605,201786,1213557,259830,323932,405155,224640,1593614,424777,189918,224796,1787719,1327095,525707,345130,456258,2011
6073,San Diego County, California,3060079,1515082,1544997,717973,1986336,355770,2913797,2185688,148272,20869,341460,12251,205257,146282,2530733,529346,2015091,302080,385841,640794,686376,2334183,725896,340847,274100,2751380,2073185,933765,550059,589361,2011
6075,San Francisco County, California,799165,405325,393840,107616,581231,110318,766605,400206,47254,2722,270500,3590,42333,32560,514547,284618,625844,88073,83502,126524,327745,500749,298416,180085,83022,715917,592516,298531,170327,123658,2011
6077,San Joaquin County, California,680356,337022,343334,196509,412045,71802,640695,416664,50498,6569,97456,3911,65597,39661,598270,82086,415430,93536,109266,136011,76617,522784,157572,74697,78731,601170,435071,163277,132926,138868,2011
6081,San Mateo County, California,721752,354649,367103,158850,465684,97218,689417,425444,19353,1677,181807,10634,50502,32335,610812,110940,508002,60179,91891,136267,219665,481174,240578,132749,57168,664424,482531,241619,136543,104369,2011
6085,Santa Clara County, California,1783371,894830,888541,427372,1155286,200713,1704238,914416,46230,10890,578029,7115,147558,79133,1525080,258291,1210628,154183,201061,296833,558551,1118869,664502,348398,139058,1643637,1200448,581076,318286,301086,2011
6099,Stanislaus County, California,513309,255274,258035,143931,315212,54166,490419,398330,14761,6046,27792,3532,39958,22890,454412,58897,314882,75549,90584,96134,52615,404727,108582,41913,69194,444061,333020,120469,100834,111717,2011
6111,Ventura County, California,820547,406913,413634,206148,515997,98402,786004,625057,15498,5714,57846,1283,80606,34543,718127,102420,535659,91043,100908,176015,167693,638406,182141,82039,83632,734092,541361,237703,179121,124537,2011
8005,Arapahoe County, Colorado,580673,285120,295553,146592,375288,58793,555129,438074,58950,3982,28268,1399,24456,25544,487442,93231,383930,33637,81648,121478,147167,491736,88937,30971,52702,526086,389985,198670,118276,73039,2011
8031,Denver County, Colorado,607662,304687,302975,132933,412354,62375,586453,436275,58669,8095,22528,765,60121,21209,418783,188879,419081,57913,76855,102118,182195,507625,100037,32246,62677,544759,424252,210566,129334,84352,2011
8041,El Paso County, Colorado,617974,305194,312780,160782,394047,63145,588454,506539,36214,3437,16829,2722,22713,29520,520617,97357,398946,23452,89160,143165,143169,573989,43985,24249,70377,532431,411247,200976,115300,94971,2011
9001,Fairfield County, Connecticut,909336,444784,464552,223501,563406,122429,892222,679770,98850,1381,44519,206,67496,17114,768717,140619,617738,66743,142813,133276,274906,731033,178303,81630,81104,827760,589121,286804,172391,129926,2011
9003,Hartford County, Connecticut,869615,416483,453132,199813,543934,125868,846406,638098,112622,2005,39582,570,53529,23209,717742,151873,598907,71787,160368,157288,209464,736771,132844,70903,106795,762425,568063,281250,167429,119384,2011
9009,New Haven County, Connecticut,834385,401881,432504,186136,528759,119490,816324,626014,103749,1830,30032,357,54342,18061,691529,142856,577436,68732,173512,145762,189430,737074,97311,47574,96050,738070,552481,269094,158310,125077,2011
10003,New Castle County, Delaware,525497,252844,272653,122346,338147,65004,512351,352667,122896,912,23667,0,12209,13146,438113,87384,352168,36298,105600,91413,118857,471727,53770,23587,56323,469008,352948,179667,93096,80185,2011
11001,District of Columbia, District of Columbia,584583,276576,308007,104750,412138,67695,572106,228001,297909,1899,20294,0,24003,12477,372320,212263,421168,52424,73291,71529,223924,504434,80149,30665,66704,516891,422514,232773,95993,93748,2011
12009,Brevard County, Florida,536439,264081,272358,103248,322302,110889,520033,447178,52475,1642,9119,515,9104,16406,432520,103919,390733,41316,108747,136908,103762,490442,45997,32200,83908,451263,336459,147087,86705,102667,2011
12011,Broward County, Florida,1764798,856937,907861,386158,1127331,251309,1725530,1136270,475320,4965,60282,363,48330,39268,1442359,322439,1227336,146032,348523,361062,371719,1209525,555273,299041,198215,1565536,1172721,558166,333548,281007,2011
12031,Duval County, Florida,853564,412719,440845,200405,556939,96220,827351,527453,251427,2920,35259,464,9828,26213,694743,158821,572042,68295,169946,187619,146182,771701,81863,47733,99592,749355,577138,277945,141154,158039,2011
12057,Hillsborough County, Florida,1246439,609055,637384,291076,807215,148148,1209137,895944,210199,9095,41869,1816,50214,37302,1015680,230759,835661,112094,245464,246164,231939,1051869,194570,84021,156343,1085893,841943,404028,208242,229673,2011
12071,Lee County, Florida,622371,306388,315983,120215,350509,151647,612284,522010,48316,3975,9345,0,28638,10087,509346,113025,456356,56209,158587,127004,114556,530659,91712,37026,81674,540462,364346,152060,102157,110129,2011
12086,Miami-Dade County, Florida,2516968,1216776,1300192,540826,1617914,358228,2483631,1893378,475269,5959,38818,651,69556,33337,2163494,353474,1733975,378294,491391,416441,447849,1208040,1308928,664520,265238,2249203,1683396,800285,370473,512638,2011
12095,Orange County, Florida,1139047,559288,579759,269859,756672,112516,1111010,746800,231466,3638,59062,1588,68456,28037,915849,223198,739182,96415,192443,231250,219074,907134,231913,107198,111856,1026238,789377,379673,215405,194299,2011
12099,Palm Beach County, Florida,1315086,632054,683032,267085,762064,285937,1290100,1011999,221448,2755,31392,447,22059,24986,1048182,266904,945291,116344,255047,264674,309226,1027119,287967,134394,149181,1165528,794988,366880,216389,211719,2011
12103,Pinellas County, Florida,903351,434030,469321,159482,553442,190427,885415,751172,92167,1988,27804,873,11411,17936,682416,220935,678945,74010,206095,218322,180518,800826,102525,55962,132019,769560,572731,280003,137099,155629,2011
12105,Polk County, Florida,594748,286683,308065,139801,344866,110081,585449,472226,85017,1392,10763,236,15815,9299,509006,85742,404461,70873,148061,115624,69903,530312,64436,20239,87914,506583,361884,150819,95096,115969,2011
12127,Volusia County, Florida,484572,236600,247972,91054,289458,104060,475084,391233,48072,3206,8515,197,23861,9488,385866,98706,352795,46940,115135,120546,70174,448755,35817,15879,79319,405253,301637,121677,74318,105642,2011
13067,Cobb County, Georgia,686515,334462,352053,173640,452048,60827,672224,436531,174917,2297,30521,346,27612,14291,574012,112503,454669,43493,91303,126386,193487,582538,103977,42479,56291,629023,472255,243649,127481,101125,2011
13089,DeKalb County, Georgia,683582,326652,356930,165523,454097,63962,669155,240903,364039,2234,34586,1803,25590,14427,544397,139185,455537,53164,98717,120193,183463,568018,115564,44521,65548,617625,470805,223398,124839,122568,2011
13121,Fulton County, Georgia,921563,447565,473998,223169,613962,84432,907667,433549,406990,1939,51478,868,12843,13896,700416,221147,615066,60142,112654,143445,298825,809675,111888,46948,85495,835771,636479,308011,161849,166619,2011
13135,Gwinnett County, Georgia,819375,403325,416050,235618,525268,58489,794317,422561,197729,3768,86233,132,83894,25058,733210,86165,513310,72810,117355,147977,175168,621902,197473,85006,60225,759060,549350,261831,144076,143443,2011
15003,Honolulu County, Hawaii,933104,462768,470336,208310,585187,139607,726386,194821,21008,2079,411683,87451,9344,206718,804742,128362,639757,59097,173737,209426,197497,750693,182411,104957,94346,814334,606652,321500,145397,139755,2011
17031,Cook County, Illinois,5135272,2486475,2648797,1210780,3311696,612796,5027309,2911959,1245893,10212,320078,366,538801,107963,4180776,954496,3445567,535146,850252,874281,1185888,4042558,1092714,507917,535745,4598650,3454482,1595452,912006,947024,2011
17043,DuPage County, Illinois,910678,446574,464104,224147,580519,106012,890617,732999,42094,995,92340,133,22056,20061,793098,117580,613918,47474,121833,165805,278806,748953,161725,89153,70450,839826,610218,315190,176438,118590,2011
17089,Kane County, Illinois,514231,256345,257886,146553,317015,50663,502018,367387,25694,1614,18105,109,89109,12213,461382,52849,324068,54646,75807,89870,103745,413048,101183,36246,39597,474553,332398,167347,94356,70695,2011
17097,Lake County, Illinois,687497,339705,347792,188660,425529,73308,672038,549185,47813,732,45011,290,29007,15459,616911,70586,444263,50277,95443,110004,188539,559424,128073,59325,53516,632544,449874,219985,130475,99414,2011
17197,Will County, Illinois,674118,332630,341488,192802,417330,63986,655703,519723,70905,1567,30213,48,33247,18415,614460,59658,427063,41327,117074,124545,144117,591358,82760,44883,50772,622626,441495,214705,124993,101797,2011
18097,Marion County, Indiana,892705,430883,461822,223177,576059,93469,867329,574203,235039,1358,16228,126,40375,25376,700961,191744,582748,87624,177484,164412,153228,820963,71742,20887,117119,775002,599057,280108,171027,147922,2011
20173,Sedgwick County, Kansas,494059,243264,250795,133798,303189,57072,469516,388288,41707,4326,18782,143,16270,24543,408496,85563,314212,34902,83963,104156,91191,450611,43448,17376,58109,433123,317270,163126,87503,66641,2011
21111,Jefferson County, Kentucky,731284,352601,378683,167996,465281,98007,712304,536081,149161,1658,16564,88,8752,18980,588995,142289,500341,58215,142771,149775,149580,683395,47889,16602,107300,623523,483722,230562,133464,119696,2011
24005,Baltimore County, Maryland,788241,372008,416233,171597,502906,113738,772655,508142,210058,1697,41229,469,11060,15586,644201,144040,544322,55189,143600,151841,193692,700162,88079,42776,95674,691986,523481,275273,136283,111925,2011
24031,Montgomery County, Maryland,980286,471786,508500,231551,628109,120626,945728,564260,171557,2012,139425,141,68333,34558,831914,148372,674867,55942,92746,139942,386237,665301,314985,158041,74650,901960,656312,360048,181101,115163,2011
24033,Prince George's County, Maryland,848763,406007,442756,200576,564441,83746,830760,178496,553405,2802,33993,43,62021,18003,709517,139246,561493,83375,147704,161257,169157,667877,180886,65612,65604,780767,587949,327713,144208,116028,2011
24510,Baltimore city, Maryland,596532,278873,317659,130047,396614,69871,582463,176584,379923,1444,13347,733,10432,14069,442271,154261,403324,76956,117444,96496,112428,552463,44069,16945,95114,501161,410460,180694,98615,131151,2011
25005,Bristol County, Massachusetts,532894,258574,274320,118653,339333,74908,520720,473635,18741,548,11297,99,16400,12174,441545,91349,369400,65034,110541,96251,97574,465723,67171,42163,75387,457120,355489,166269,109326,79894,2011
25009,Essex County, Massachusetts,733892,352280,381612,168895,460979,104018,718243,591474,24046,1513,24421,28,76761,15649,616391,117501,505061,54555,133662,130287,186557,623075,110817,60005,84155,649398,480432,242528,138434,99470,2011
25017,Middlesex County, Massachusetts,1464603,715536,749067,316631,954396,193576,1423687,1182763,66763,1821,140288,367,31685,40916,1179260,285343,1039088,80895,228695,203924,525574,1170515,294088,139979,132505,1330652,993549,526414,287436,179699,2011
25025,Suffolk County, Massachusetts,691583,334524,357059,127871,489786,73926,655492,382305,163649,1564,56164,110,51700,36091,469236,222347,472009,79217,112060,92543,188189,497815,193768,87844,82178,609291,504039,232333,153906,117800,2011
25027,Worcester County, Massachusetts,777198,381393,395805,182367,496040,98791,760759,664575,30715,2394,32555,106,30414,16439,648140,129058,529327,56609,148127,145729,178862,690184,87014,45954,90236,686394,519992,250481,156521,112990,2011
26081,Kent County, Michigan,598476,293176,305300,154661,377916,65899,578531,491742,57511,2127,13576,224,13351,19945,499333,99143,384398,37534,105687,119137,122040,552576,45900,19393,62901,535468,394664,184045,124809,85810,2011
26099,Macomb County, Michigan,834200,404575,429625,188599,525515,120086,818864,705321,74944,3053,27699,57,7790,15336,706670,127530,575778,66481,183813,197075,128409,746131,88069,47974,115644,717955,548788,241719,165317,141752,2011
26125,Oakland County, Michigan,1200400,582485,617915,275827,763181,161392,1168156,929125,162241,2768,67573,314,6135,32244,998619,201781,833674,60781,178913,235417,358563,1069543,130857,74509,133395,1066203,797749,376086,229553,192110,2011
26163,Wayne County, Michigan,1782960,856571,926389,442776,1114997,225187,1741743,948590,713691,5416,47210,141,26695,41217,1484393,298567,1164213,187605,355081,374074,247453,1643140,139820,78682,278944,1503866,1169873,422167,315277,432429,2011
27053,Hennepin County, Minnesota,1146619,563241,583378,260017,758061,128541,1107175,867788,134220,10143,70897,120,24007,39444,878222,268397,785732,59555,140789,222701,362687,999613,147006,63725,107499,1038554,785191,402134,246014,137043,2011
27123,Ramsey County, Minnesota,501686,243373,258313,118490,322670,60526,483048,351090,54260,3631,61323,138,12606,18638,389641,112045,331487,36469,73931,94419,126668,425026,76660,34264,53803,447883,335481,159071,107493,68917,2011
29095,Jackson County, Missouri,664120,321242,342878,160639,421523,81958,641491,445541,154452,2991,11334,1631,25542,22629,531501,132619,443860,56292,127102,137223,123243,623135,40985,14651,86271,577682,438231,208775,123926,105530,2011
29189,St. Louis County, Missouri,979623,463945,515678,226860,608924,143839,958006,691637,227036,1099,33699,0,4535,21617,817312,162311,672165,50995,153046,197780,270344,913177,66446,32110,110708,868633,636868,322618,181409,132841,2011
31055,Douglas County, Nebraska,512915,251727,261188,133512,325548,53855,498274,399637,56566,3601,15031,123,23316,14641,411891,101024,332194,30744,77568,104050,119832,468672,44243,13660,50530,461413,338785,181746,98859,58180,2011
32003,Clark County, Nevada,1946168,975526,970642,481848,1235430,228890,1861933,1318804,200403,11689,167603,13136,150298,84235,1614168,332000,1287902,215149,381787,404100,286866,1520503,425665,173875,208064,1729908,1287504,592357,336129,359018,2011
34003,Bergen County, New Jersey,900942,435567,465375,200495,565482,134965,885094,647709,51393,1022,134226,232,50512,15848,786933,114009,634228,57042,154098,129527,293561,629893,271049,159660,77139,823649,589184,317264,131794,140126,2011
34007,Camden County, New Jersey,506955,244465,262490,122383,320237,64335,490315,329606,92748,1111,27005,293,39552,16640,428201,78754,338789,43151,106370,91106,98162,451868,55087,26496,62436,444334,334494,151951,94090,88453,2011
34013,Essex County, New Jersey,765495,364429,401066,191378,485851,88266,741542,339830,301731,1569,34807,108,63497,23953,648611,116884,505302,81013,147864,115905,160520,561368,204127,92412,87636,677859,507569,238403,120455,148711,2011
34017,Hudson County, New Jersey,634267,315001,319266,130907,438275,65085,615350,347246,78665,2366,87125,552,99396,18917,504245,130022,444492,77083,116687,89991,160731,377874,256393,113724,59080,575187,452861,237532,102737,112592,2011
34023,Middlesex County, New Jersey,789987,386748,403239,182737,508949,98301,771865,500708,69503,1481,174751,521,24901,18122,692172,97815,538949,58583,148156,120010,212200,533159,256828,133343,68505,721111,529261,275143,127727,126391,2011
34029,Ocean County, New Jersey,571778,273818,297960,133991,319225,118562,560454,524070,17039,858,9780,48,8659,11324,488989,82789,395572,42445,148658,103579,100890,526041,45737,22065,73452,497991,333029,144668,99330,89031,2011
34031,Passaic County, New Jersey,494282,240339,253943,122599,312421,59262,472047,337062,59792,1787,26219,325,46862,22235,438756,55526,323434,58707,117070,68440,79217,347119,147163,71075,50187,444095,326916,156271,69867,100778,2011
34039,Union County, New Jersey,533042,258881,274161,129130,337701,66211,523983,302545,112758,835,24652,610,82583,9059,463583,69459,358351,50415,108209,87710,112017,375227,157815,74785,49543,483450,352857,176336,93306,83215,2011
35001,Bernalillo County, New Mexico,662220,324016,338204,158191,421568,82461,635682,452425,18802,31050,12592,721,120092,26538,531274,130946,437289,52867,106423,137157,140842,590388,71832,27230,79662,580632,439074,202049,122817,114208,2011
36005,Bronx County, New York,1357260,634634,722626,360455,858183,138622,1308683,302764,460617,7547,47678,745,489332,48577,1159832,197428,842936,254431,232768,207185,148552,890543,466717,203152,189005,1167981,903164,369782,211428,321954,2011
36029,Erie County, New York,892277,429463,462814,192266,560432,139579,870533,715021,113822,4272,22522,62,14834,21744,710163,182114,616015,63785,176896,185191,190143,836613,55664,27503,118758,773035,585087,273060,171785,140242,2011
36047,Kings County, New York,2512502,1187318,1325184,591160,1635097,286245,2464016,1098810,852414,8114,267757,1479,235442,48486,2051465,461037,1664551,358697,459767,347103,498984,1570206,942296,521126,234781,2277082,1699934,771115,382107,546712,2011
36055,Monroe County, New York,720060,347378,372682,161871,457537,100652,700222,548131,110342,1510,22447,61,17731,19838,572436,147624,488814,51718,121315,140052,175729,663180,56880,34034,86378,633498,477896,224490,137164,116242,2011
36059,Nassau County, New York,1325155,641653,683502,304898,819121,201136,1293880,950214,146471,3081,104008,54,90052,31275,1190657,134498,912259,84188,224412,223950,379709,1037820,287335,176192,111738,1212826,858672,440360,208378,209934,2011
36061,New York County, New York,1556394,735989,820405,234017,1109670,212707,1491967,871596,233555,4142,167207,857,214610,64427,974922,581472,1180295,163355,155634,172640,688666,1104012,452382,206084,155558,1400680,1133917,580454,287683,265780,2011
36081,Queens County, New York,2220676,1077877,1142799,455114,1484823,280739,2142137,925320,418762,6925,518567,1240,271323,78539,1885148,335528,1556494,302258,432731,344585,476920,1136476,1084200,569623,214067,2005925,1540012,752116,356827,431069,2011
36103,Suffolk County, New York,1472159,723540,748619,347932,925481,198746,1442738,1198134,108609,2764,47846,370,85015,29421,1316479,155680,1000236,97516,302080,268389,332251,1264102,208057,106034,130282,1341465,967796,493622,248240,225934,2011
36119,Westchester County, New York,929372,447801,481571,221424,572308,135640,899238,622919,131562,1277,52083,0,91397,30134,801370,128002,638271,77840,140747,128473,291211,700548,228824,109601,80112,848913,599580,304871,146940,147769,2011
37119,Mecklenburg County, North Carolina,930570,450562,480008,237313,610887,82370,905861,542020,285052,2354,44162,852,31421,24709,759080,171490,611983,65030,123649,173913,249391,804162,126408,43681,80184,850042,634888,319678,177483,137727,2011
37183,Wake County, North Carolina,908099,440156,467943,238420,588764,80915,891392,621050,189337,2133,50530,0,28342,16707,755373,152726,594885,52917,104445,155484,282039,790690,117409,43281,65859,841648,612495,327009,155165,130321,2011
39035,Cuyahoga County, Ohio,1244838,590172,654666,279338,775379,190121,1215933,803006,364882,1994,32635,339,13077,28905,972427,272411,860485,106423,250089,249983,253990,1152257,92581,53406,175973,1068494,809961,372407,219717,217837,2011
39049,Franklin County, Ohio,1154122,561412,592710,276777,762219,115126,1115997,804902,242588,1868,44196,73,22370,38125,885683,268439,754861,80823,195876,213642,264520,1050129,103993,42128,138574,1014871,790770,398033,210285,182452,2011
39061,Hamilton County, Ohio,784486,377278,407208,185485,497752,101249,766436,545588,200284,713,15344,406,4101,18050,624336,160150,523020,58305,140815,147253,176647,745891,38595,14302,100723,683579,519274,243100,148702,127472,2011
39113,Montgomery County, Ohio,517034,247509,269525,119654,315834,81546,505777,383327,107457,1202,9657,0,4134,11257,411815,105219,357659,43600,103981,122284,87794,497265,19769,9689,83769,430917,328770,151222,91425,86123,2011
39153,Summit County, Ohio,529943,254649,275294,119117,333552,77274,517203,427411,74110,1268,12335,0,2079,12740,428009,101934,364188,32733,118763,109172,103520,508328,21615,12279,70074,459869,347944,171236,91878,84830,2011
40109,Oklahoma County, Oklahoma,717630,350216,367414,183672,448389,85569,672273,494382,106794,23854,21153,752,25338,45357,576380,141250,465557,66639,115317,141917,141684,640130,77500,22718,97005,618443,466987,228593,128488,109906,2011
40143,Tulsa County, Oklahoma,601349,293869,307480,153253,376082,72014,559191,433581,62516,28825,14352,539,19378,42158,494079,107270,392335,42261,101417,129697,118960,554963,46386,14747,82778,517702,391139,201944,100640,88555,2011
41051,Multnomah County, Oregon,733194,361529,371665,149500,506249,77445,706418,576665,41281,6046,49206,4777,28443,26776,521347,211847,520764,55865,103592,157330,203977,625198,107996,42192,85013,648006,520737,222792,182368,115577,2011
41067,Washington County, Oregon,533620,261926,271694,133748,344438,55434,517151,403329,9878,5916,49575,3825,44628,16469,443853,89767,356366,31528,68971,113733,142134,442670,90950,37572,48222,485300,359385,171008,114155,74222,2011
42003,Allegheny County, Pennsylvania,1195277,571351,623926,237072,761893,196312,1172056,974211,155967,1554,33632,440,6252,23221,928057,267220,853283,59485,272335,221056,300407,1136709,58568,27972,158575,1036503,791260,402336,218191,170733,2011
42045,Delaware County, Pennsylvania,538222,256800,281422,126781,334202,77239,528207,389819,106362,546,25890,77,5513,10015,454963,83259,366508,29227,117833,93256,126192,488945,49277,28055,63727,474469,350108,173533,94843,81732,2011
42071,Lancaster County, Pennsylvania,508620,248599,260021,126355,307007,75258,497246,459236,15871,586,9514,45,11994,11374,432492,76128,337348,50675,136485,74260,75928,488003,20617,11995,58507,449726,321525,161697,94421,65407,2011
42091,Montgomery County, Pennsylvania,784802,379708,405094,179393,488544,116865,769112,647468,65714,632,50803,211,4284,15690,660720,124082,549955,34010,137390,128177,250378,711570,73232,41815,70273,714357,510406,278118,137286,95002,2011
42101,Philadelphia County, Pennsylvania,1492682,703635,789047,341234,972200,179248,1455603,620222,639986,2766,93083,478,99068,37079,1131099,361583,979939,186501,335215,225789,232434,1305352,187330,94298,233606,1258639,1010330,402901,245362,362067,2011
44007,Providence County, Rhode Island,600090,289145,310945,133299,386876,79915,581746,447008,51829,3743,22593,138,56435,18344,473588,126502,406204,77760,108233,107963,112248,488821,111269,52930,76723,523222,402240,192447,112375,97418,2011
47037,Davidson County, Tennessee,611947,294396,317551,136245,411642,64060,598566,376853,167992,1896,17273,310,34242,13381,458175,153772,417811,56079,106233,109182,146317,537693,74254,23963,65974,545367,424228,215638,118758,89832,2011
47157,Shelby County, Tennessee,917556,436436,481120,240372,582047,95137,902599,374760,475261,1112,22575,0,28891,14957,757921,159635,585503,75390,161615,169744,178754,861594,55962,18272,118139,799010,610257,285801,154532,169924,2011
48029,Bexar County, Texas,1720129,837734,882395,466783,1075810,177536,1661891,1294879,118962,11077,40036,1411,195526,58238,1466917,253212,1078090,190802,262517,336700,288071,1491264,228865,85181,233007,1475760,1127134,551282,286212,289640,2011
48085,Collin County, Texas,807421,397066,410355,228149,514780,64492,783776,594061,66640,3597,92753,653,26072,23645,719180,88241,520433,38460,77967,146528,257478,667473,139948,65388,49522,757189,538178,308768,120927,108483,2011
48113,Dallas County, Texas,2387110,1181477,1205633,660860,1516651,209599,2324899,1371365,511468,7303,123874,1309,309580,62211,2013192,373918,1494111,346419,346622,377071,423999,1822931,564179,145857,220005,2165819,1588773,823341,353137,412295,2011
48121,Denton County, Texas,674949,333667,341282,184985,440292,49672,654184,529793,55800,3848,45420,441,18882,20765,567460,107489,425470,31651,82272,137785,173762,577806,97143,40770,48493,626136,460303,260671,116396,83236,2011
48141,El Paso County, Texas,805466,387333,418133,241006,480535,83925,786350,646541,25148,3583,8846,1130,101102,19116,722473,82993,474510,124632,112254,139094,98530,594275,211191,86909,97154,694926,509017,229566,120108,159343,2011
48157,Fort Bend County, Texas,599547,294238,305309,173897,379105,46545,587478,328316,125474,1247,105559,0,26882,12069,560969,38578,377331,40604,72822,113304,150601,445182,154365,79272,41376,558149,398315,217869,82485,97961,2011
48201,Harris County, Texas,4135032,2056362,2078670,1149507,2641760,343765,4046976,2569124,771055,16440,255956,2445,431956,88056,3564000,571032,2579384,549688,608540,693599,727557,3103716,1031316,338767,380349,3752761,2763137,1391968,653993,717176,2011
48215,Hidalgo County, Texas,790642,384369,406273,273479,443170,73993,784206,736433,2802,1588,8578,0,34805,6436,742410,48232,431568,165723,105270,91447,69128,548237,242405,65766,108535,681808,472816,174979,143711,154126,2011
48439,Tarrant County, Texas,1825124,893780,931344,508851,1152971,163302,1778801,1324352,271823,13508,85059,2827,81232,46323,1573568,251556,1147225,178717,277499,358353,332656,1542380,282744,98294,184551,1639054,1206518,633296,289570,283652,2011
48453,Travis County, Texas,1041547,524414,517133,252131,711935,77481,1015179,753721,87304,7337,57153,238,109426,26368,791412,250135,676077,87611,113714,172712,302040,848541,193006,47361,83921,957175,737310,378890,213352,145068,2011
49035,Salt Lake County, Utah,1034128,518684,515444,298875,644453,90800,1004995,875559,16953,8207,34315,15782,54179,29133,895225,138903,629158,69830,146662,219011,193655,905520,128608,47989,90675,943104,673118,333325,205020,134773,2011
49049,Utah County, Utah,518440,259809,258631,182039,301876,34525,507625,476493,3320,3120,8146,5270,11276,10815,472629,45811,254002,17341,44582,102238,89841,477034,41406,14323,36017,481702,317926,120421,127913,69592,2011
51059,Fairfax County, Virginia,1092105,540286,551819,263514,717968,110623,1036956,687662,103202,3966,191780,842,49504,55149,950585,141520,748779,53951,99795,150349,444684,776035,316070,160930,70081,1010866,745299,426014,182966,136319,2011
53033,King County, Washington,1941316,969193,972123,411884,1314184,215248,1847365,1356670,121365,14584,285931,14838,53977,93951,1496303,445013,1365382,112678,240684,384855,627165,1535806,405510,195574,193052,1745728,1360664,673911,405360,281393,2011
53053,Pierce County, Washington,789777,393226,396551,192293,508253,89231,733569,597035,50437,7993,48497,10318,19289,56208,659147,130630,518799,46154,156175,194243,122227,709236,80541,43486,104695,673265,530624,235647,153212,141765,2011
53061,Snohomish County, Washington,709703,352398,357305,169017,466079,74607,677906,570785,14270,8234,66665,3206,14746,31797,591048,118655,479734,41977,119433,185146,133178,608358,101345,52392,79778,626346,486694,230375,143151,113168,2011
55079,Milwaukee County, Wisconsin,932012,449682,482330,234934,592154,104924,900910,583051,244411,4522,31988,303,36635,31102,722507,209505,600799,83123,176463,173680,167533,849088,82924,32422,121828,809782,618138,277178,186852,154108,2011
1073,Jefferson County, Alabama,646961,304760,342201,153718,406275,86968,640377,344705,275455,1183,9898,182,8954,6584,531966,114995,436489,49696,110404,141141,135248,619564,27397,9240,91584,554794,424027,204726,96336,122965,2012
4013,Maricopa County, Arizona,3889500,1919812,1969688,995355,2387858,506287,3782798,3133210,205048,72149,143321,7620,221450,106702,3215009,674491,2520113,333310,583944,836867,765992,3315437,574063,215188,386974,3500121,2497550,1227567,616931,653052,2012
4019,Pima County, Arizona,968447,473604,494843,219040,587743,161664,933964,752748,36332,29161,25920,1017,88786,34483,771900,196547,652194,78978,142164,231438,199614,847247,121200,55791,129958,833584,611169,275415,170521,165233,2012
6001,Alameda County, California,1525055,748564,776491,338802,1007668,178585,1428237,694457,180343,10514,408892,14037,119994,96818,1257636,267419,1049799,137755,191191,273302,447551,1051331,473724,256473,139824,1383464,1046194,492342,290337,263515,2012
6013,Contra Costa County, California,1070057,521709,548348,256458,672141,141458,1008867,673104,96102,6478,158817,5336,69030,61190,919563,150494,723905,82616,132981,222121,286187,812080,257977,138155,108547,960929,702002,318930,198152,184920,2012
6019,Fresno County, California,930872,460856,470016,273863,559469,97540,893248,520109,47649,10194,91801,1209,222286,37624,815295,115577,551353,151717,122876,173505,103255,721435,209437,73901,108661,821384,589888,218943,173358,197587,2012
6029,Kern County, California,825020,412277,412743,251968,494039,79013,798942,590849,41472,11662,39380,1452,114127,26078,742269,82751,481671,131140,121528,152560,76443,652333,172687,56000,90690,733391,521169,211176,145805,164188,2012
6037,Los Angeles County, California,9808116,4832216,4975900,2326253,6365438,1116425,9422290,5241801,812360,44350,1361369,23990,1938420,385826,8308703,1499413,6465575,1465066,1331571,1714381,1954557,6358856,3449260,1657365,935876,8869109,6649392,2942739,1774302,1932351,2012
6059,Orange County, California,3054106,1510927,1543179,724140,1954101,375865,2938963,1949507,45380,10805,570702,9281,353288,115143,2645760,408346,2025401,323305,360352,583409,758335,2106880,947226,477528,247515,2804312,2041650,957203,567936,516511,2012
6065,Riverside County, California,2234117,1106340,1127777,611982,1343998,278137,2143082,1469346,136187,22566,129427,6989,378567,91035,1980898,253219,1387770,284752,344461,471854,286703,1744881,489236,215567,240311,1989132,1415244,570200,382165,462879,2012
6067,Sacramento County, California,1431110,697055,734055,357047,904851,169212,1339702,853178,140497,12755,216516,14988,101768,91408,1184209,246901,932902,125489,207466,336242,263705,1137344,293766,160386,179704,1250071,946104,397941,262905,285258,2012
6071,San Bernardino County, California,2035052,1002576,1032476,575674,1264891,194487,1952505,1276045,177292,21242,133971,6960,336995,82547,1842737,192315,1229299,268053,316814,414194,230238,1591345,443707,203337,219896,1808493,1336177,528740,336481,470956,2012
6073,San Diego County, California,3098088,1537473,1560615,718918,2007458,371712,2957814,2181471,153971,25709,360316,15305,221042,140274,2564723,533365,2051211,284213,389510,658640,718848,2368492,729596,353333,293382,2764552,2091649,950454,569502,571693,2012
6075,San Francisco County, California,812148,413588,398560,108535,589954,113659,773675,402087,44863,2600,272273,3381,48471,38473,511880,300268,640003,86191,82123,127404,344285,518472,293676,171738,84674,727424,601662,308214,167756,125692,2012
6077,San Joaquin County, California,688873,340234,348639,197943,415951,74979,634022,387794,47869,5135,98091,4029,91104,54851,618917,69956,421401,90790,107358,143067,80186,526594,162279,75047,80030,608735,437458,167489,130919,139050,2012
6081,San Mateo County, California,733455,360449,373006,159676,472859,100920,703166,419121,18949,2502,191318,9990,61286,30289,613817,119638,519038,58010,86812,146187,228029,480311,253144,137467,55182,678273,489353,254306,136886,98161,2012
6085,Santa Clara County, California,1811694,911384,900310,430449,1172000,209245,1735531,908494,47405,9121,602044,6858,161609,76163,1565259,246435,1233368,171110,181146,298289,582823,1131430,680264,353748,140356,1670915,1216994,605479,308077,303438,2012
6099,Stanislaus County, California,515955,253629,262326,143138,314851,57966,493948,391447,13979,3310,27386,3884,53942,22007,458964,56991,318790,70455,91564,105084,51687,412615,103340,42470,68498,447139,332628,123371,100173,109084,2012
6111,Ventura County, California,824845,409099,415746,205117,516193,103535,788648,644530,16071,4072,56612,1430,65933,36197,728424,96421,539464,92653,98035,177811,170965,635098,189747,84179,80555,741628,539376,249555,161324,128497,2012
8005,Arapahoe County, Colorado,589986,289908,300078,145798,380302,63886,563194,441540,61268,4589,31591,1177,23029,26792,491731,98255,394160,32917,77597,128281,155365,500303,89683,41754,54142,534427,395709,207640,109510,78559,2012
8031,Denver County, Colorado,622622,311716,310906,137095,420639,64888,600763,471021,62947,5748,20926,422,39699,21859,430221,192401,432379,59384,76270,101753,194972,525575,97047,32282,60335,562090,432803,229805,119937,83061,2012
8041,El Paso County, Colorado,626467,310783,315684,160759,397769,67939,595095,511929,40008,3706,16407,1283,21762,31372,530785,95682,404932,22564,87802,152115,142451,574951,51516,25904,68820,539532,414437,206173,114623,93641,2012
8059,Jefferson County, Colorado,534953,264338,270615,113734,349115,72104,520468,487612,5807,4873,13445,69,8662,14485,434615,100338,377232,23200,78589,117478,157965,500841,34112,16768,50153,484742,362315,196121,100860,65334,2012
9001,Fairfield County, Connecticut,915813,447272,468541,222583,567910,125320,892198,682682,101207,2372,46487,315,59135,23615,788033,127780,623263,54211,142291,135203,291558,727167,188646,76126,82701,832875,594437,294635,173575,126227,2012
9003,Hartford County, Connecticut,872655,420028,452627,196431,547358,128866,844735,647772,113234,2918,39873,1759,39179,27920,714850,157805,604462,65862,163228,158139,217233,742836,129819,67165,101239,771146,570904,286897,159800,124207,2012
9009,New Haven County, Connecticut,838123,403658,434465,185325,528967,123831,820118,634896,106698,3472,31042,0,44010,18005,693742,144381,580480,67335,173938,146866,192341,730628,107495,53037,96740,740881,549940,265708,156634,127598,2012
10003,New Castle County, Delaware,529630,255799,273831,122102,339052,68476,516445,350468,126476,851,24804,98,13748,13185,438221,91409,355913,33265,101472,97017,124159,473659,55971,27503,57895,471119,352591,183299,92579,76713,2012
11001,District of Columbia, District of Columbia,598151,282010,316141,107877,420466,69808,583814,236314,298073,2180,19257,54,27936,14337,378177,219974,431807,47558,78103,73972,232174,511112,87039,35284,69158,527064,430906,236177,100872,93857,2012
12009,Brevard County, Florida,540315,264170,276145,103273,321303,115739,526912,451719,54021,1146,11849,2519,5658,13403,440893,99422,394792,39456,114445,134425,106466,492153,48162,30348,80379,458709,334082,145893,90827,97362,2012
12011,Broward County, Florida,1801389,874046,927343,388460,1150468,262461,1749527,1133528,489167,3573,59999,1006,62254,51862,1464266,337123,1257081,144939,351650,383889,376603,1229592,571797,314855,191907,1608655,1197002,584889,328521,283592,2012
12031,Duval County, Florida,860581,414822,445759,199915,558868,101798,829917,533761,245358,2335,37571,1058,9834,30664,697080,163501,577965,70007,166155,187451,154352,779928,80653,38333,112847,742451,579504,273715,138988,166801,2012
12057,Hillsborough County, Florida,1258568,614129,644439,292804,809708,156056,1223040,912881,209929,4097,43697,493,51943,35528,1016309,242259,844697,105574,235404,250372,253347,1055336,203232,96653,154727,1100146,842893,415604,205833,221456,2012
12071,Lee County, Florida,636067,312392,323675,120723,355688,159656,624324,539652,51495,1825,11165,0,20187,11743,526993,109074,468946,60811,149198,144817,114120,542132,93935,40642,94216,541790,369425,156846,101715,110864,2012
12086,Miami-Dade County, Florida,2551967,1234660,1317307,540368,1641449,370150,2516759,1941299,475276,3106,41765,700,54613,35208,2194179,357788,1769590,342804,511308,428047,487431,1242124,1309843,695017,262761,2286905,1704292,821351,380917,502024,2012
12095,Orange County, Florida,1174247,574567,599680,275740,779508,118999,1138882,758821,248897,1874,56956,100,72234,35365,953805,220442,767198,98201,203627,232438,232932,948208,226039,106288,119174,1054386,813052,391081,228011,193960,2012
12099,Palm Beach County, Florida,1338251,645275,692976,270326,772981,294944,1309167,1014239,234350,1908,34026,1177,23467,29084,1083710,254541,961431,120104,242957,279189,319181,1036483,301768,146648,148663,1189121,806382,382679,224625,199078,2012
12103,Pinellas County, Florida,907779,434624,473155,158227,552129,197423,886502,756027,92477,3324,27849,504,6321,21277,687701,220078,684999,69050,213730,207468,194751,799166,108613,61251,133911,773204,571804,285608,139691,146505,2012
12105,Polk County, Florida,600528,290459,310069,140305,346044,114179,585689,475449,89005,1784,10315,213,8923,14839,512488,88040,409837,66818,147159,115786,80074,539558,60970,25328,89905,510433,362142,159261,87101,115780,2012
12127,Volusia County, Florida,486465,235949,250516,89959,288903,107603,477620,406070,51235,1761,7642,249,10663,8845,389084,97381,355245,41280,122517,115933,75515,451314,35151,20556,74126,411635,299686,129224,66889,103573,2012
13067,Cobb County, Georgia,695283,336589,358694,175357,452808,67118,681062,442583,177591,364,32347,104,28073,14221,584398,110885,460023,38599,87878,129614,203932,589018,106265,43264,56161,638053,472415,247518,125727,99170,2012
13089,DeKalb County, Georgia,693646,332664,360982,167835,460098,65713,680817,241428,376752,1538,34678,0,26421,12829,552310,141336,463646,56746,97657,122730,186513,582016,111630,37559,66643,626183,475173,233265,114910,126998,2012
13121,Fulton County, Georgia,948111,458201,489910,227000,629404,91707,924930,434378,419304,3246,53202,308,14492,23181,730246,217865,634702,59913,106066,152990,315733,825008,123103,42850,90063,857413,652571,330976,155495,166100,2012
13135,Gwinnett County, Georgia,836907,410113,426794,237335,535325,64247,815633,436947,205234,3767,91974,318,77393,21274,754034,82873,525218,61579,132094,154111,177434,634069,202838,84525,59734,776507,562058,285411,125948,150699,2012
15003,Honolulu County, Hawaii,945975,470565,475410,208134,594334,143507,733286,195106,21439,1953,414854,92724,7210,212689,813842,132133,649849,60799,171757,205820,211473,759653,186322,105107,96987,823446,616976,325833,157532,133611,2012
17031,Cook County, Illinois,5151537,2497444,2654093,1203204,3321397,626936,5041929,2946576,1242231,12779,333993,2051,504299,109608,4195943,955594,3470018,521941,829558,898232,1220287,4053481,1098056,513748,545208,4605752,3459097,1665512,888737,904848,2012
17043,DuPage County, Illinois,915331,450582,464749,220493,583041,111797,893744,735084,43411,1353,94768,739,18389,21587,800110,115221,621102,45137,118887,167073,290005,738063,177268,94060,75556,839480,612041,321576,168623,121842,2012
17089,Kane County, Illinois,515901,258248,257653,144791,316556,54554,506323,379387,27719,2413,18462,220,78122,9578,461391,54510,327153,55536,78690,89056,103871,421682,94219,33795,37454,478268,334088,166090,94754,73244,2012
17097,Lake County, Illinois,684185,338210,345975,182254,425307,76624,667399,559071,47248,1272,43987,412,15409,16786,603635,80550,445004,49227,95300,110045,190432,557404,126781,60439,53175,629414,448334,226494,125708,96132,2012
17197,Will County, Illinois,674103,332928,341175,188723,417466,67914,658706,506411,72930,1666,33302,37,44360,15397,608188,65915,428638,38172,115273,133606,141587,597001,77102,39405,57388,616715,439739,226140,118168,95431,2012
18097,Marion County, Indiana,901338,434780,466558,226689,578523,96126,874791,561762,240695,3675,18224,162,50273,26547,713482,187856,588054,87780,167823,163626,168825,830266,71072,17438,117698,783027,601796,288492,174608,138696,2012
20173,Sedgwick County, Kansas,497261,244988,252273,133538,304596,59127,479739,398576,46498,4905,20465,24,9271,17522,417366,79895,316097,33788,85250,106739,90320,456298,40963,16691,59294,435671,317990,162767,85030,70193,2012
21111,Jefferson County, Kentucky,736895,356854,380041,169298,467014,100583,717816,540741,153050,729,17669,208,5419,19079,588029,148866,504311,55117,140914,151803,156477,686317,50578,19901,107308,628465,485200,240808,133133,111259,2012
24005,Baltimore County, Maryland,796529,377540,418989,174120,504019,118390,775508,512240,210289,1677,43177,527,7598,21021,652659,143870,551822,51873,156012,145343,198594,703118,93411,44137,89297,706227,524109,278913,131301,113895,2012
24031,Montgomery County, Maryland,996632,480047,516585,234215,636261,126156,953553,566415,169335,3317,143207,412,70867,43079,850379,146253,686628,60877,101423,132375,391953,669935,326697,159459,75588,918426,662791,376907,169406,116478,2012
24033,Prince George's County, Maryland,860321,412491,447830,199743,572438,88140,834921,170310,550965,2752,35203,0,75691,25400,717873,142448,572765,82427,151024,164958,174356,678427,181894,72092,76550,780921,593765,336209,140168,117388,2012
24510,Baltimore city, Maryland,598255,278900,319355,131843,394863,71549,586755,179793,381963,1862,14252,46,8839,11500,441589,156666,405626,76647,118769,99851,110359,552892,45363,15223,94569,503222,408388,182867,99900,125621,2012
25005,Bristol County, Massachusetts,534291,258959,275332,117457,338278,78556,520735,474568,18467,1211,10905,0,15584,13556,443686,90605,372407,62377,112604,101441,95985,469068,65223,41014,76168,457895,353482,167971,100415,85096,2012
25009,Essex County, Massachusetts,739567,356018,383549,168369,463500,107698,724319,590721,32416,874,23884,134,76290,15248,619633,119934,509963,55319,137909,130601,186134,626291,113276,57902,87337,651895,483963,244545,134775,104643,2012
25017,Middlesex County, Massachusetts,1482545,721683,760862,317422,963661,201462,1443236,1188124,69097,1953,147164,182,36716,39309,1196370,286175,1055782,79058,225392,214666,536666,1199186,283359,136545,136224,1345322,1000882,536448,289548,174886,2012
25025,Suffolk County, Massachusetts,701494,338728,362766,129965,494601,76928,658114,386538,164819,2175,58639,0,45943,43380,473816,227678,486098,75514,117923,97277,195384,507456,194038,85780,90010,611287,509230,244457,152103,112670,2012
25027,Worcester County, Massachusetts,781577,384306,397271,180350,498858,102369,760477,666266,33610,1939,34796,156,23710,21100,644005,137572,533584,52688,152793,147004,181099,693975,87602,49138,90246,690949,521311,258699,147208,115404,2012
26081,Kent County, Michigan,604867,296957,307910,155642,380212,69013,584737,499487,58296,2818,13382,0,10754,20130,500769,104098,389924,39744,103503,123143,123534,557977,46890,18971,66896,537613,396418,186587,124857,84974,2012
26099,Macomb County, Michigan,839211,407616,431595,187218,528154,123839,820754,706595,80088,1684,26924,0,5463,18457,706491,132720,580277,66080,180587,202497,131113,752954,86257,51221,112318,726682,552136,260294,157124,134718,2012
26125,Oakland County, Michigan,1210002,586634,623368,273427,766919,169656,1178144,928258,165444,3662,71511,22,9247,31858,1005530,204472,842860,59707,174986,239396,368771,1065455,144547,80202,133998,1075770,801476,393308,230568,177600,2012
26163,Wayne County, Michigan,1773105,852013,921092,433585,1109534,229986,1730020,947094,706165,6078,45636,260,24787,43085,1468850,304255,1162282,182953,352765,378210,248354,1634499,138606,72980,285685,1487030,1161483,436533,309063,415887,2012
27053,Hennepin County, Minnesota,1164502,573445,591057,264131,765132,135239,1127570,876232,140464,7233,76720,372,26549,36932,895200,269302,798422,56753,144424,219880,377365,1016946,147556,67172,107063,1057218,792418,421934,239756,130728,2012
27123,Ramsey County, Minnesota,506985,247369,259616,120708,323869,62408,487553,358212,55647,1868,64976,20,6830,19432,392823,114162,335433,31029,75299,95558,133547,433328,73657,35009,58330,448353,336519,163405,108408,64706,2012
29095,Jackson County, Missouri,664975,321793,343182,160154,420621,84200,648234,443477,159315,4362,10645,1154,29281,16741,527635,137340,446013,45707,135894,140412,124000,630151,34824,14242,86851,578040,438154,216669,118120,103365,2012
29189,St. Louis County, Missouri,979741,464180,515561,222893,607467,149381,956999,684912,227054,1162,35430,14,8427,22742,806692,173049,674509,50680,148596,198359,276874,908156,71585,34406,113821,865481,635041,330998,174058,129985,2012
31055,Douglas County, Nebraska,518535,254824,263711,135786,326452,56297,506925,403995,58617,2885,15525,79,25824,11610,417158,101377,336717,37760,73757,99203,125997,470700,47835,12686,49488,468549,340383,184107,94195,62081,2012
32003,Clark County, Nevada,1975043,989318,985725,482220,1249734,243089,1885774,1276510,207088,12135,178324,13818,197899,89269,1629193,345850,1313509,200934,389672,430702,292201,1541745,433298,189877,233293,1735731,1303829,598882,353057,351890,2012
34003,Bergen County, New Jersey,908282,439048,469234,200474,568195,139613,880715,646852,49689,1990,137573,132,44479,27567,792204,116078,642115,49016,157001,133642,302456,629891,278391,163156,75002,833060,592434,319827,130565,142042,2012
34007,Camden County, New Jersey,507162,244744,262418,120743,319096,67323,491949,323212,100226,1269,27475,0,39767,15213,431979,75183,341214,42402,104676,91814,102322,453346,53816,28824,68201,438923,332836,156467,92571,83798,2012
34013,Essex County, New Jersey,769060,366782,402278,190871,487328,90861,745888,318083,304315,2536,37048,432,83474,23172,644225,124835,509997,85098,141989,116464,166446,578425,190635,94294,102664,666396,508257,234512,131418,142327,2012
34017,Hudson County, New Jersey,646136,320599,325537,132523,446982,66631,628312,359865,84450,3161,93005,193,87638,17824,517859,128277,454002,79263,116637,90217,167885,374801,271335,123956,59142,586788,461664,245046,101437,115181,2012
34023,Middlesex County, New Jersey,798196,389514,408682,182772,512786,102638,782060,500059,72534,1304,182903,0,25260,16136,696221,101975,545920,62117,137178,117028,229597,545245,252951,126008,65471,732563,535062,272496,131561,131005,2012
34029,Ocean County, New Jersey,573525,275273,298252,134228,317813,121484,565993,528701,17974,1825,10430,0,7063,7532,486411,87114,396410,35719,146644,109474,104573,529936,43589,24045,73757,499200,332019,151238,102347,78434,2012
34031,Passaic County, New Jersey,494210,239981,254229,121415,311543,61252,472419,340891,67954,1654,24222,0,37698,21791,437445,56765,323629,59706,107415,70921,85587,351050,143160,71184,44601,449334,324995,161504,72804,90687,2012
34039,Union County, New Jersey,537296,260624,276672,129699,340216,67381,526133,319314,117828,451,25344,0,63196,11163,470169,67127,361704,50501,109192,86279,115732,389579,147717,67964,47747,489450,354073,177106,92957,84010,2012
35001,Bernalillo County, New Mexico,663258,323996,339262,157256,419135,86867,637161,456732,18879,29035,14735,665,117115,26097,536888,126370,441240,51622,106858,140348,142412,592231,71027,24476,84377,576993,437107,213798,106263,117046,2012
36005,Bronx County, New York,1374278,640802,733476,363161,866477,144640,1328575,285326,454260,7441,50960,155,530433,45703,1168307,205971,853845,255999,230156,210063,157627,890282,483996,219185,176804,1197092,909057,373662,209119,326276,2012
36029,Erie County, New York,893393,429737,463656,190775,560289,142329,875270,712218,117388,4098,22761,173,18632,18123,704607,188786,618000,57153,175504,190998,194345,840209,53184,30537,116479,776424,584844,281656,172323,130865,2012
36047,Kings County, New York,2547456,1204900,1342556,597167,1652752,297537,2490647,1120633,870006,7120,280649,788,211451,56809,2073628,473828,1695661,363179,452391,347562,532529,1563991,983465,542884,247741,2299033,1717746,795024,390027,532695,2012
36055,Monroe County, New York,723395,350084,373311,161153,457041,105201,705861,551745,111519,2376,23405,153,16663,17534,565891,157504,492434,44374,124950,149654,173456,664603,58792,31164,91142,632253,476609,237178,135966,103465,2012
36059,Nassau County, New York,1328872,645281,683591,300558,821161,207153,1290131,948451,148811,2590,106775,105,83399,38741,1202537,126335,917848,88498,227905,219125,382320,1035386,293486,177147,111338,1217248,860813,441864,217228,201721,2012
36061,New York County, New York,1570809,745180,825629,238073,1112660,220076,1508085,891249,240677,4611,177150,1558,192840,62724,964348,606461,1199282,164751,146846,176292,711393,1111846,458963,219875,154388,1415807,1136046,615789,269214,251043,2012
36081,Queens County, New York,2248849,1090936,1157913,460458,1499153,289238,2173479,938118,409229,10205,535295,960,279672,75370,1904419,344430,1578041,318291,425901,361678,472171,1165913,1082936,594435,218135,2030005,1551968,770123,356868,424977,2012
36103,Suffolk County, New York,1468231,721018,747213,339316,918783,210132,1438508,1215653,106162,3456,50073,153,63011,29723,1304285,163946,1003931,101900,296242,265085,340704,1246559,221672,101968,133140,1334414,965476,490962,249338,225176,2012
36119,Westchester County, New York,937992,452502,485490,221969,575702,140321,910473,624559,131214,3752,51649,263,99036,27519,805085,132907,643884,77326,133388,136790,296380,688674,249318,125947,86831,851029,602728,301603,156395,144730,2012
37081,Guilford County, North Carolina,486835,232914,253921,113888,309106,63841,477949,279219,161250,2484,21473,65,13458,8886,397883,88952,325188,39120,85151,94533,106384,431693,55142,19747,47938,438615,321804,154326,84422,83056,2012
37119,Mecklenburg County, North Carolina,954023,459988,494035,240552,625457,88014,928435,549952,292886,4459,47804,980,32354,25588,761351,192672,629568,65170,125984,176719,261695,817284,136739,44137,78681,874777,650317,333778,178131,138408,2012
37183,Wake County, North Carolina,929108,452681,476427,240553,603182,85373,908218,638113,193002,3396,52340,241,21126,20890,773545,155563,611154,48196,104661,165164,293133,807512,121596,46252,68508,859265,628692,338909,165282,124501,2012
39035,Cuyahoga County, Ohio,1239009,587501,651508,274608,771105,193296,1213938,791797,372425,2669,32337,216,14494,25071,971647,267362,858981,106018,242157,251000,259806,1157721,81288,50554,176878,1061428,804781,374986,220008,209787,2012
39049,Franklin County, Ohio,1169005,568596,600409,281107,768157,119741,1131414,807771,251457,2505,48253,571,20857,37591,910033,258972,768407,75434,193162,212422,287389,1057359,111646,47722,136742,1031741,794764,406190,213849,174725,2012
39061,Hamilton County, Ohio,783135,377081,406054,183167,496298,103670,766962,540132,202928,1687,16749,64,5402,16173,607798,175337,525816,58194,146023,144398,177201,746069,37066,16375,95209,687849,516099,251035,149050,116014,2012
39113,Montgomery County, Ohio,518208,249941,268267,119328,317087,81793,504453,381595,109065,443,10052,153,3145,13755,407646,110562,356390,41113,103900,121284,90093,498525,19683,7545,83483,433373,329325,153991,87064,88270,2012
39153,Summit County, Ohio,531914,257808,274106,117441,334461,80012,516768,428480,74306,857,12033,246,846,15146,424966,106948,366731,34059,122061,102643,107968,507213,24701,14495,66117,465631,349192,174036,89406,85750,2012
40109,Oklahoma County, Oklahoma,728161,355183,372978,186360,454096,87705,679873,503199,107054,21785,23163,424,24248,48288,580760,147401,472237,63430,121974,143950,142883,651934,76227,20987,92968,632466,473015,239830,122286,110899,2012
40143,Tulsa County, Oklahoma,603542,293741,309801,153335,375609,74598,558509,436231,59788,28126,15313,622,18429,45033,493907,109635,394754,44911,102871,127976,118996,554403,49139,15067,77461,525697,391390,207647,96082,87661,2012
41051,Multnomah County, Oregon,745334,368525,376809,150841,511304,83189,714597,590641,42719,5839,49175,5260,20963,30737,542034,203300,532704,48828,97593,168087,218196,646861,98473,44880,93848,651359,527241,233967,178701,114573,2012
41067,Washington County, Oregon,541898,267615,274283,134988,348183,58727,517844,414908,9488,4320,48209,2297,38622,24054,448426,93472,362608,33602,69486,113250,146270,448423,93475,41398,53792,487429,362765,182585,99916,80264,2012
42003,Allegheny County, Pennsylvania,1196603,574912,621691,234659,761016,200928,1168833,972827,153710,1625,35605,238,4828,27770,918868,277735,859533,53237,253088,233795,319413,1135469,61134,28868,158369,1037627,790278,410145,215089,165044,2012
42045,Delaware County, Pennsylvania,539696,257960,281736,126005,334404,79287,529570,388360,110000,760,27127,166,3157,10126,457045,82651,367806,27396,118502,91040,130868,488170,51526,29084,61929,477740,348935,179465,88691,80779,2012
42071,Lancaster County, Pennsylvania,512363,250627,261736,126629,308135,77599,501345,455268,17430,614,10279,0,17754,11018,442669,69694,340644,53304,130439,72598,84303,492400,19963,9882,56603,455679,322761,164294,90814,67653,2012
42091,Montgomery County, Pennsylvania,788180,382052,406128,178248,489040,120892,772032,647195,65205,1262,52697,64,5609,16148,666392,121788,552424,32108,140054,119956,260306,708982,79198,41961,75226,712523,511979,279561,136925,95493,2012
42101,Philadelphia County, Pennsylvania,1506286,709460,796826,345346,979200,181740,1462327,613801,656485,5680,95236,4338,86787,43959,1140811,365475,991499,182422,334601,230968,243508,1324810,181476,93270,255495,1250384,1018984,415662,246489,356833,2012
44007,Providence County, Rhode Island,602402,291196,311206,133182,387230,81990,582443,446660,58572,3097,23157,121,50836,19959,476838,125564,408237,69960,118571,110813,108893,491210,111192,52671,77635,524286,403533,191882,112603,99048,2012
47037,Davidson County, Tennessee,625304,300510,324794,139121,418422,67761,610675,386504,173786,1065,20104,82,29134,14629,465578,159726,428171,53360,102321,111965,160525,552760,72544,24478,74136,550897,430517,224772,115134,90611,2012
47157,Shelby County, Tennessee,923074,438513,484561,239650,584742,98682,908521,379332,480422,3014,22911,406,22436,14553,770142,152932,590264,78016,155346,182550,174352,867829,55245,19510,114282,807968,613048,290847,154200,168001,2012
48029,Bexar County, Texas,1750665,856762,893903,466506,1097314,186845,1699188,1299309,128657,13216,43917,2689,211400,51477,1502163,248502,1104260,190896,270152,352247,290965,1511112,239553,93165,226940,1515224,1150668,573541,283027,294100,2012
48085,Collin County, Texas,830115,408475,421640,230324,528475,71316,803696,608953,74911,3852,98293,204,17483,26419,727963,102152,536778,34734,81207,155518,265319,679907,150208,69730,47883,781846,553374,321516,121889,109969,2012
48113,Dallas County, Texas,2424114,1196613,1227501,665585,1540001,218528,2367257,1429496,538273,8918,130959,1857,257754,56857,2046629,377485,1523043,337949,357965,394515,432614,1860917,563197,156047,225359,2197888,1607517,838107,364557,404853,2012
48121,Denton County, Texas,694697,342487,352210,188663,452972,53062,667925,543886,57664,3027,48784,413,14151,26772,596438,98259,443166,34416,83307,149090,176353,601514,93183,37491,58559,636092,473609,262862,121858,88889,2012
48141,El Paso County, Texas,812645,392138,420507,239817,486896,85932,795640,674824,26676,4719,8879,1108,79434,17005,737083,75562,481225,118057,116536,144884,101748,605795,206850,88527,100246,699777,515838,229936,122085,163817,2012
48157,Fort Bend County, Texas,622049,303914,318135,177350,392718,51981,600604,324964,128774,1375,110081,126,35284,21445,583938,38111,393040,48113,69568,107324,168035,457255,164794,87205,48703,573164,414636,218173,87059,109404,2012
48201,Harris County, Texas,4211148,2094400,2116748,1158270,2689154,363724,4125013,2687785,787653,19080,267948,3336,359211,86135,3626671,584477,2637201,550412,616452,712839,757498,3158682,1052466,344259,405969,3803765,2810293,1425079,685247,699967,2012
48215,Hidalgo County, Texas,796479,386552,409927,273748,445617,77114,791971,736444,4096,4669,8388,25,38349,4508,744565,51914,435720,158283,105312,100259,71866,565488,230991,62790,122377,673897,475643,191227,125378,159038,2012
48439,Tarrant County, Texas,1856067,911747,944320,511484,1170789,173794,1811785,1343052,282725,7943,89359,2697,86009,44282,1596923,259144,1170785,182504,269638,368625,350018,1548409,307658,97499,181913,1672507,1221248,644253,298648,278347,2012
48453,Travis County, Texas,1072380,540482,531898,256794,732689,82897,1036963,832676,90167,6042,61709,776,45593,35417,803411,268969,705254,91698,118268,178197,317091,883780,188600,55321,96989,974387,758374,397244,216893,144237,2012
49035,Salt Lake County, Utah,1050033,526072,523961,301777,653526,94730,1023264,875672,18197,8641,37846,16090,66818,26769,901010,149023,642982,71156,137566,224100,210160,918063,131970,42212,94765,954624,682572,344608,200088,137876,2012
49049,Utah County, Utah,527200,265905,261295,184305,306281,36614,513598,487332,2627,2541,6797,4054,10247,13602,480165,47035,261585,18428,45833,101843,95481,491842,35358,13543,36458,490199,322662,133710,123673,65279,2012
51059,Fairfax County, Virginia,1108999,548359,560640,264718,726404,117877,1057865,695829,99126,2070,200146,468,60226,51134,956275,152724,761057,68158,101126,147105,444668,776195,332804,171650,68844,1028896,756089,440869,183662,131558,2012
53033,King County, Washington,1976957,986953,990004,416074,1333734,227149,1862582,1366988,122464,14247,289868,15001,54014,114375,1509318,467639,1394472,109591,238935,403885,642061,1559081,417876,204368,183971,1790146,1379795,705959,395740,278096,2012
53053,Pierce County, Washington,795152,393272,401880,192977,508185,93990,741390,597734,53310,10485,47025,10634,22202,53762,660676,134476,526623,46218,156789,196711,126905,718228,76924,43803,98673,684891,530550,255068,141544,133938,2012
53061,Snohomish County, Washington,723125,360388,362737,170016,472724,80385,683763,574963,16981,6676,67707,2718,14718,39362,605658,117467,490532,39578,120579,183830,146545,615706,107419,54302,79870,641142,492035,244316,136078,111641,2012
55025,Dane County, Wisconsin,489738,243237,246501,105481,330902,53355,478149,416377,26613,1482,25332,0,8345,11589,365609,124129,326142,15836,63911,95164,151231,450925,38813,14527,43553,446096,342048,178490,116747,46811,2012
55079,Milwaukee County, Wisconsin,934152,449564,484588,234054,591561,108537,906369,578423,245450,6137,32970,124,43265,27783,724634,209518,605812,82441,171589,178415,173367,846873,87279,32320,124901,809140,617292,290008,172468,154816,2012
1073,Jefferson County, Alabama,644588,303916,340672,150114,405618,88856,635453,340709,272004,1968,8823,12,11937,9135,526122,118466,438756,50068,114060,136009,138619,621451,23137,7812,96248,548113,420867,201174,102504,117189,2013
4013,Maricopa County, Arizona,3959308,1954369,2004939,1000706,2426559,532043,3834109,3166528,202884,73157,145795,7431,238314,125199,3295811,663497,2582051,342610,603406,843965,792070,3365629,593679,217836,422009,3534133,2537709,1234481,626662,676566,2013
4019,Pima County, Arizona,970384,473803,496581,214501,587257,168626,932725,759493,30736,29781,24267,1459,86989,37659,769767,200617,644635,81691,148332,218577,196035,845151,125233,53268,136298,830695,611784,267537,180219,164028,2013
6001,Alameda County, California,1550103,760335,789768,338285,1023838,187980,1447661,697321,178398,9625,423082,12860,126375,102442,1266706,283397,1076144,137320,201366,278271,459187,1061453,488650,256485,150089,1398624,1060927,495466,302754,262707,2013
6013,Contra Costa County, California,1083531,528647,554884,256339,679593,147599,1018001,662313,95376,5361,164096,5250,85605,65530,934883,148648,735326,82876,138062,226591,287797,823746,259785,134670,124302,958403,709765,326899,202033,180833,2013
6019,Fresno County, California,937990,465517,472473,273888,562590,101512,902222,581999,47007,10541,93879,1499,167297,35768,830843,107147,559266,144720,123431,178900,112215,740891,197099,73862,120417,817216,590568,226751,174436,189381,2013
6029,Kern County, California,831344,414248,417096,251805,497778,81761,806554,624534,42275,7816,38657,843,92429,24790,742923,88421,487905,123119,134587,157430,72769,659557,171787,53962,95525,734675,525681,205509,146458,173714,2013
6037,Los Angeles County, California,9864324,4860474,5003850,2290214,6415462,1158648,9498412,5285015,810472,64552,1384910,25319,1928144,365912,8349078,1515246,6564955,1509067,1336663,1735186,1984039,6423325,3440999,1672343,978975,8881647,6691397,3019789,1774735,1896873,2013
6059,Orange County, California,3076430,1522824,1553606,715284,1970288,390858,2966822,1940941,52198,11343,581865,10480,369995,109608,2664877,411553,2057941,323586,369506,597865,766984,2158067,918363,478519,269924,2804333,2054286,980656,568836,504794,2013
6065,Riverside County, California,2257870,1118851,1139019,604412,1362897,290561,2153824,1454504,137325,19195,138004,6509,398287,104046,2011109,246761,1418103,277140,367111,473651,300201,1762963,494907,224987,260744,1992470,1434121,582558,396397,455166,2013
6067,Sacramento County, California,1441178,700279,740899,356085,906403,178690,1342592,866994,139979,11151,214870,14590,95008,98586,1191641,249537,945555,124039,221208,331702,268606,1141897,299281,167882,185177,1255489,948350,395889,264312,288149,2013
6071,San Bernardino County, California,2041043,1005190,1035853,569941,1266895,204207,1951198,1311484,178616,14071,137372,7237,302418,89845,1840905,200138,1242741,258749,320660,422480,240852,1614773,426270,204779,220543,1814987,1334962,535373,348391,451198,2013
6073,San Diego County, California,3129334,1557561,1571773,714046,2025564,389724,2980774,2234473,151400,19891,356154,14957,203899,148560,2594128,535206,2089036,301094,406308,653687,727947,2375436,753898,360793,304522,2787347,2105751,969331,552103,584317,2013
6075,San Francisco County, California,823902,419848,404054,109724,597090,117088,787479,400424,46327,3826,276831,3481,56590,36423,517920,305982,654604,86238,81783,138233,348350,534181,289721,177657,91155,731572,608051,319940,172082,116029,2013
6077,San Joaquin County, California,690366,341283,349083,194751,417178,78437,632419,383032,46534,2904,99412,3612,96925,57947,616832,73534,425294,93648,107904,150105,73637,529749,160617,70283,87479,602698,440596,172619,128661,139316,2013
6081,San Mateo County, California,741938,365296,376642,161192,475649,105097,705200,413020,18735,1477,197306,10376,64286,36738,624405,117533,525716,55095,91237,136204,243180,490200,251738,143355,58139,683422,491940,249738,146573,95629,2013
6085,Santa Clara County, California,1833880,920797,913083,430107,1185621,218152,1748948,862097,48632,8792,617434,5689,206304,84932,1579411,254469,1254964,166039,187831,303432,597662,1129777,704103,379431,142345,1690856,1229639,619573,318760,291306,2013
6099,Stanislaus County, California,518152,255983,262169,140907,316395,60850,494814,374029,14059,2987,30819,1367,71553,23338,456679,61473,322813,73321,92875,104533,52084,411911,106241,45767,70520,447590,331349,128606,107338,95405,2013
6111,Ventura County, California,827429,410681,416748,202711,517142,107576,791746,656131,13309,4838,57966,963,58539,35683,726406,101023,545460,90441,109400,174947,170672,637537,189892,88295,87259,738120,540263,261193,154046,125024,2013
8005,Arapahoe County, Colorado,602200,296439,305761,148052,386557,67591,574364,436778,58611,2211,32855,1240,42669,27836,498149,104051,402274,32836,83730,126902,158806,515657,86543,36130,55435,545580,403095,206843,116078,80174,2013
8031,Denver County, Colorado,636761,318569,318192,135176,433723,67862,613927,494557,61906,4982,20686,897,30899,22834,436674,200087,449263,60855,80385,106399,201624,538877,97884,30218,61052,574986,444983,240645,120116,84222,2013
8041,El Paso County, Colorado,637647,317103,320544,163505,403150,70992,600037,508382,36725,3752,17809,2428,30941,37610,536605,101042,410758,27411,79369,157772,146206,594412,43235,22923,74468,543288,419417,209361,120101,89955,2013
9001,Fairfield County, Connecticut,921302,450135,471167,221099,572089,128114,895675,678613,102372,2649,43985,236,67820,25627,788543,132759,626785,70610,131893,136433,287849,718501,202801,86147,81961,839175,599440,292668,178799,127973,2013
9003,Hartford County, Connecticut,873953,421951,452002,194586,547334,132033,842624,633273,116488,447,42856,140,49420,31329,728975,144978,606919,66407,165690,153394,221428,744103,129850,71248,107020,766637,570802,282311,162986,125505,2013
9009,New Haven County, Connecticut,836150,403589,432561,182049,527366,126735,818419,636246,106173,979,31287,101,43633,17731,688363,147787,582278,57233,178408,149589,197048,741134,95016,48316,90079,745008,550605,265265,152232,133108,2013
10003,New Castle County, Delaware,532764,255277,277487,120949,340589,71226,518766,346879,128779,1068,26949,456,14635,13998,443275,89489,361599,34554,101679,96460,128906,481372,51392,23837,61633,471044,352838,185942,94071,72825,2013
11001,District of Columbia, District of Columbia,611788,288134,323654,109340,431055,71393,592376,247573,301052,1265,20981,104,21401,19412,390359,221429,445621,43328,81264,73301,247728,522556,89232,36805,67906,542349,440948,241784,101421,97743,2013
12009,Brevard County, Florida,545062,266988,278074,102385,322557,120120,531757,455753,56421,1615,13007,0,4961,13305,444228,100834,400237,37636,111776,144339,106486,499804,45258,30606,82630,461368,336216,147125,86479,102612,2013
12011,Broward County, Florida,1823100,884717,938383,395803,1154328,272969,1780180,1145071,508747,3490,63131,850,58891,42920,1507102,315998,1271603,146148,343890,392869,388696,1244837,578263,330075,215466,1606375,1200832,585587,319540,295705,2013
12031,Duval County, Florida,865163,416854,448309,198738,560508,105917,836782,536379,251254,2748,38512,892,6997,28381,696025,169138,587555,61075,165490,198502,162488,783118,82045,44195,112075,747990,582322,287901,137449,156972,2013
12057,Hillsborough County, Florida,1270545,619577,650968,295337,812682,162526,1234589,915511,208762,2792,48815,166,58543,35956,1037310,233235,857310,107120,235246,246404,268540,1071153,199392,99251,144563,1120176,846450,434859,197430,214161,2013
12071,Lee County, Florida,649199,316403,332796,122469,359020,167710,638289,545779,55862,1143,9936,168,25401,10910,543764,105435,481711,65559,149872,139293,126987,547038,102161,44968,95892,553071,372791,157818,108441,106532,2013
12086,Miami-Dade County, Florida,2573211,1242524,1330687,537827,1652252,383132,2537993,1971316,464687,3576,42137,200,56077,35218,2211872,361339,1797414,346969,518056,445554,486835,1228829,1344382,736175,262518,2309124,1714429,857332,362951,494146,2013
12095,Orange County, Florida,1189316,584137,605179,274028,789711,125577,1149468,746759,241451,3459,62899,280,94620,39848,964891,224425,790004,96991,214627,226195,252191,961848,227468,110269,120853,1067677,818437,401274,221581,195582,2013
12099,Palm Beach County, Florida,1354693,654142,700551,267501,783643,303549,1321126,1010747,241818,2609,33232,152,32568,33567,1088194,266499,979181,118935,255125,284496,320625,1029075,325618,159844,168080,1186337,815794,400563,225135,190096,2013
12103,Pinellas County, Florida,913241,437314,475927,156479,552383,204379,888100,754212,92241,2156,28685,447,10359,25141,679259,233982,690936,69936,205559,219163,196278,806936,106305,60497,127711,784398,570358,282541,145913,141904,2013
12105,Polk County, Florida,608424,295339,313085,141048,350134,117242,590640,480225,89442,1890,10309,138,8636,17784,517859,90565,417850,67341,145454,127204,77851,548415,60009,24392,97037,511272,366226,167113,82439,116674,2013
12127,Volusia County, Florida,490077,236906,253171,89112,288802,112163,479293,407658,48093,1208,8339,192,13803,10784,387699,102378,361078,37360,122650,123160,77908,456558,33519,21980,80327,409591,300953,130314,71955,98684,2013
13067,Cobb County, Georgia,707652,342501,365151,176855,459518,71279,690914,437260,189815,1249,35838,429,26323,16738,591375,116277,468633,40895,95375,130135,202228,598183,109469,46148,60516,646953,480056,252868,127509,99679,2013
13089,DeKalb County, Georgia,699993,334038,365955,167000,464095,68898,683572,259261,373158,1970,37026,15,12142,16421,548493,151500,471613,52067,100165,125615,193766,583868,116125,41312,74245,625699,479950,239369,124555,116026,2013
13121,Fulton County, Georgia,952715,459463,493252,229065,626182,97468,928895,438027,418285,2047,55311,302,14923,23820,729955,222760,639801,55236,114964,158618,310983,828641,124074,50526,93308,858872,651035,336607,149584,164844,2013
13135,Gwinnett County, Georgia,851967,417185,434782,238835,543292,69840,832627,446258,217508,2297,94427,535,71602,19340,763232,88735,536052,73886,124172,159991,178003,645146,206821,87699,65163,785621,572143,292317,146150,133676,2013
15003,Honolulu County, Hawaii,951718,475715,476003,209703,592784,149231,735159,200141,25711,1105,412141,85990,10071,216559,821088,130630,654500,60809,167154,206875,219662,769321,182397,108078,104332,813066,614747,332099,151611,131037,2013
17031,Cook County, Illinois,5150356,2500610,2649746,1180339,3328645,641372,5037481,2949286,1227680,13818,342682,1647,502368,112875,4186327,964029,3497936,510235,841801,896326,1249574,4041445,1108911,519339,549510,4599820,3461938,1658860,902056,901022,2013
17043,DuPage County, Illinois,919258,452305,466953,219946,582353,116959,896741,735608,42095,1998,99442,376,17222,22517,801695,117563,623325,46883,117225,165602,293615,748517,170741,95692,73874,844733,609669,321844,170255,117570,2013
17089,Kane County, Illinois,517212,257189,260023,142380,316512,58320,508503,376634,28756,1344,19236,239,82294,8709,458523,58689,329590,58694,80733,88711,101452,420262,96950,33876,43764,473390,332124,172262,93727,66135,2013
17097,Lake County, Illinois,686069,339680,346389,180159,425466,80444,667207,552000,45506,1196,45376,0,23129,18862,608112,77957,446209,48850,88343,116996,192020,557864,128205,63127,54803,629998,447313,233747,119705,93861,2013
17197,Will County, Illinois,673217,332129,341088,184527,417177,71513,656963,502609,72694,395,33044,0,48221,16254,607900,65317,429264,41353,113777,134020,140114,590059,83158,43123,63764,609373,440289,218339,126931,95019,2013
18097,Marion County, Indiana,907845,436649,471196,225205,583375,99265,883906,561271,247262,1896,20990,0,52487,23939,716420,191425,596422,86199,167651,177270,165302,827284,80561,21233,126406,781211,605782,291217,171674,142891,2013
20173,Sedgwick County, Kansas,498103,246486,251617,133144,304209,60750,479397,404768,46180,3805,19927,0,4717,18706,416060,82043,318737,33390,83526,105707,96114,455206,42897,18860,59629,436041,317803,166143,83078,68582,2013
21111,Jefferson County, Kentucky,742376,358213,384163,169224,469459,103693,720757,545137,153319,735,17547,394,3625,21619,587822,154554,510039,56419,139551,153769,160300,692017,50359,18203,106410,635365,487726,244663,130854,112209,2013
24005,Baltimore County, Maryland,802713,381535,421178,175348,504431,122934,780187,506896,217292,2671,44044,389,8895,22526,664226,138487,560035,52272,150668,156058,201037,716160,86553,42785,93194,709083,524776,290660,129271,104845,2013
24031,Montgomery County, Maryland,1008376,487147,521229,237122,639603,131651,964599,560489,174625,2262,145810,157,81256,43777,865867,142509,694150,59760,105135,135643,393612,676966,331410,178612,80796,924680,666307,378462,173965,113880,2013
24033,Prince George's County, Maryland,870701,418810,451891,199827,577023,93851,851377,174134,558804,3467,36154,132,78686,19324,734887,135814,586384,86125,154279,168000,177980,689547,181154,72932,76760,791401,597466,336732,141064,119670,2013
24510,Baltimore city, Maryland,597292,279606,317686,128898,396232,72162,584943,178838,378338,2500,13410,356,11501,12349,432376,164916,411279,72897,118915,99868,119599,553957,43335,18887,98491,498455,408632,191799,101123,115710,2013
25005,Bristol County, Massachusetts,535671,260256,275415,116071,338527,81073,518871,468234,16562,650,10547,308,22570,16800,444245,91426,373210,62414,114373,103918,92505,468415,67256,42808,77683,457824,353227,166766,101856,84605,2013
25009,Essex County, Massachusetts,745635,359682,385953,167011,467039,111585,730223,597963,31702,390,25714,443,74011,15412,628683,116952,514662,51796,133410,134829,194627,628318,117317,62679,90609,654743,487887,242196,144411,101280,2013
25017,Middlesex County, Massachusetts,1495277,729304,765973,317659,969570,208048,1445591,1190587,68896,2017,149358,111,34622,49686,1202355,292922,1066180,79094,223339,204312,559435,1200913,294364,148087,143925,1350506,1007235,539528,289585,178122,2013
25025,Suffolk County, Massachusetts,712780,345555,367225,128613,505405,78762,672154,384569,160321,3674,55819,0,67771,40626,484998,227782,503535,77369,120399,94579,211188,502996,209784,96528,93836,618894,517327,258765,153310,105252,2013
25027,Worcester County, Massachusetts,783695,384629,399066,175122,501769,106804,763123,669310,35672,1643,35162,213,21123,20572,653921,129774,539725,49878,159589,143777,186481,686821,96874,48156,93453,689738,524306,261018,144477,118811,2013
26081,Kent County, Michigan,611358,301118,310240,155067,384610,71681,590059,501542,58979,2877,15011,49,11601,21299,502377,108981,398166,43416,94670,124067,136013,566359,44999,17994,73130,537985,401950,191068,127539,83343,2013
26099,Macomb County, Michigan,846457,410926,435531,186627,532682,127148,826097,706783,85534,1897,29235,301,2347,20360,708566,137891,586697,70858,173681,205184,136974,752199,94258,54129,119922,726113,557724,265573,156873,135278,2013
26125,Oakland County, Michigan,1221247,592995,628252,273882,770955,176410,1189687,932726,169656,2721,77583,85,6916,31560,1010318,210929,850383,60106,172739,243709,373829,1070985,150262,79577,144021,1076734,805135,404894,226172,174069,2013
26163,Wayne County, Michigan,1756440,844174,912266,424826,1096971,234643,1718531,934908,688827,6312,51949,192,36343,37909,1454823,301617,1157492,174401,347058,378886,257147,1614771,141669,75351,293636,1462240,1146626,450866,298529,397231,2013
27053,Hennepin County, Minnesota,1175573,578298,597275,263367,771939,140267,1132871,870909,139627,6810,79395,513,35617,42702,890968,284605,812556,58135,147751,226399,380271,1018439,157134,79394,117061,1058002,798351,431868,235454,131029,2013
27123,Ramsey County, Minnesota,511679,249196,262483,120052,327685,63942,491855,352740,57458,4862,67522,58,9215,19824,391906,119773,342040,32558,73882,94298,141302,435029,76650,38967,54527,457144,340255,170534,107464,62257,2013
29095,Jackson County, Missouri,669703,324033,345670,160847,421983,86873,649196,447169,158252,3115,11219,1913,27528,20507,526826,142877,450170,46221,134386,142358,127205,631501,38202,14503,90453,579049,438179,225510,112679,99990,2013
29189,St. Louis County, Missouri,980448,464966,515482,221472,605461,153515,955458,686484,225882,1512,35352,64,6164,24990,814302,166146,675725,44780,141039,201219,288687,920278,60170,33255,117169,863097,632828,335983,168708,128137,2013
31055,Douglas County, Nebraska,526044,258293,267751,136788,331000,58256,510335,424093,57008,1677,15336,249,11972,15709,425038,101006,343369,39239,70528,107264,126338,476283,49761,15912,56899,469007,345068,187305,97727,60036,2013
32003,Clark County, Nevada,2002803,1000420,1002383,482192,1263363,257248,1913290,1258265,211818,10390,187089,14210,231518,89513,1662221,340582,1339776,204876,389251,447448,298201,1564343,438460,210232,248893,1749582,1319199,619712,353030,346457,2013
34003,Bergen County, New Jersey,914137,442762,471375,201730,569918,142489,897573,635861,53739,1965,145586,82,60340,16564,798796,115341,644550,52312,156625,130094,305519,637015,277122,162590,74818,839078,594906,317850,135361,141695,2013
34007,Camden County, New Jersey,505832,244552,261280,119070,317545,69217,489412,319303,101334,498,28292,0,39985,16420,431369,74463,342742,39512,111197,92679,99354,451198,54634,30380,72346,433312,330480,154273,96942,79265,2013
34013,Essex County, New Jersey,770876,367008,403868,189707,488038,93131,748889,318637,310346,2051,37782,0,80073,21987,649170,121706,512313,75691,149885,117637,169100,573145,197731,103219,101611,669265,509948,234234,132333,143381,2013
34017,Hudson County, New Jersey,653812,324822,328990,133441,452227,68144,631359,367029,81516,2357,96333,59,84065,22453,515627,138185,461779,80192,118566,92696,170325,371490,282322,129760,68309,585407,465852,244515,108017,113320,2013
34023,Middlesex County, New Jersey,802417,393031,409386,183004,513969,105444,784035,488316,76070,1154,184092,0,34403,18382,701603,100814,552913,64421,137451,123944,227097,538736,263681,138820,76070,726285,535621,278254,133073,124294,2013
34029,Ocean County, New Jersey,574587,275172,299415,134346,316763,123478,567376,527827,17094,616,11457,0,10382,7211,491745,82842,397599,42462,145088,106246,103803,531261,43326,25171,78706,495225,330506,151318,101366,77822,2013
34031,Passaic County, New Jersey,497853,242782,255071,122481,312069,63303,477279,327674,65609,2479,27340,126,54051,20574,442872,54981,327130,55818,117900,70281,83131,352424,145429,72724,44063,453790,326821,159499,75791,91531,2013
34039,Union County, New Jersey,540926,264272,276654,129709,342847,68370,529953,308959,114541,1585,26407,481,77980,10973,471855,69071,364727,51393,106118,88301,118915,378525,162401,84216,50621,490251,356771,176893,95122,84756,2013
35001,Bernalillo County, New Mexico,666172,325987,340185,155881,420018,90273,641662,519714,21159,26848,16420,642,56879,24510,539774,126398,446040,52881,104319,140756,148084,592944,73228,24485,93167,571547,437344,207102,117091,113151,2013
36005,Bronx County, New York,1379387,646472,732915,354638,876764,147985,1327791,279363,455068,7710,50811,1437,533402,51596,1170752,208635,867211,243910,243545,217545,162211,906708,472679,219558,195920,1182773,916236,375790,212795,327651,2013
36029,Erie County, New York,893457,429596,463861,187909,560164,145384,873176,705633,117969,3827,24708,240,20799,20281,704304,189153,623405,58051,172181,193587,199586,837573,55884,27609,121869,771343,582408,284259,167428,130721,2013
36047,Kings County, New York,2571598,1218035,1353563,598084,1668410,305104,2513203,1109922,876226,8993,292882,750,224430,58395,2092069,479529,1725317,365001,448391,344601,567324,1612268,959330,538576,247887,2322832,1732230,806830,412311,513089,2013
36055,Monroe County, New York,723613,348385,375228,158618,456728,108267,706011,546273,113544,2970,24799,398,18027,17602,572556,151057,497949,47096,123259,146201,181393,667661,55952,33866,93839,629467,476963,235933,132875,108155,2013
36059,Nassau County, New York,1331298,645536,685762,298471,821386,211441,1274255,927468,148442,4070,113550,296,80429,57043,1199561,131737,921284,89220,215583,220292,396189,1042019,289279,175532,114680,1216293,860160,441937,222397,195826,2013
36061,New York County, New York,1580465,748891,831574,235647,1119475,225343,1519045,891050,237043,5020,180540,2247,203145,61420,970532,609933,1217347,160384,158082,160035,738846,1126474,453991,228629,155384,1424906,1142803,610547,274335,257921,2013
36081,Queens County, New York,2270581,1103483,1167098,461234,1511080,298267,2197296,959911,414671,6015,559727,1250,255722,73285,1920533,350048,1602191,306872,437676,367443,490200,1171947,1098634,612064,216818,2053448,1561694,787465,353093,421136,2013
36103,Suffolk County, New York,1470600,723403,747197,335322,919936,215342,1433779,1188666,112304,4741,52082,448,75538,36821,1307406,163194,1007144,101605,294257,267030,344252,1246088,224512,111392,138922,1331415,962723,486805,252865,223053,2013
36119,Westchester County, New York,944176,455739,488437,219385,580932,143859,920039,621576,132626,2919,52698,0,110220,24137,815702,128474,649448,79532,123904,138448,307564,700008,244168,120109,86456,857568,605723,312744,160314,132665,2013
37081,Guilford County, North Carolina,491582,234274,257308,114040,312024,65518,482219,278060,164243,3307,22329,543,13737,9363,398437,93145,330606,34883,81832,98931,114960,445528,46054,13862,54168,436832,325120,155269,85521,84330,2013
37119,Mecklenburg County, North Carolina,974793,468678,506115,242174,638715,93904,950351,540273,305948,3301,48034,73,52722,24442,775193,199600,647456,71679,120935,182582,272260,829284,145509,49351,91150,883108,662244,346204,181459,134581,2013
37183,Wake County, North Carolina,950090,463650,486440,243167,615817,91106,928943,647730,192205,2988,58267,472,27281,21147,774167,175923,627583,51446,101791,163317,311029,827924,122166,45040,77719,871341,640200,352205,168743,119252,2013
39035,Cuyahoga County, Ohio,1236419,587918,648501,270022,771238,195159,1203824,787445,363828,2878,34380,270,15023,32595,963142,273277,859898,96339,238072,252750,272737,1148946,87473,55710,180090,1056132,803949,385300,214860,203789,2013
39049,Franklin County, Ohio,1183643,576660,606983,282413,776515,124715,1140958,815947,252924,1557,49484,314,20732,42685,906670,276973,789318,80597,200089,211639,296993,1065924,117719,45257,144963,1037554,805312,424489,218539,162284,2013
39061,Hamilton County, Ohio,786061,377538,408523,183899,495430,106732,766983,542675,199300,1492,18001,489,5026,19078,612104,173957,529899,59994,143148,143449,183308,745244,40817,19490,101389,684541,516139,248354,150171,117614,2013
39113,Montgomery County, Ohio,520853,249710,271143,118326,319310,83217,505884,383894,107696,880,9165,270,3979,14969,415902,104951,356869,37503,103239,126493,89634,500762,20091,10133,81402,438321,332423,155806,93963,82654,2013
39153,Summit County, Ohio,533277,258241,275036,117194,333515,82568,519844,426113,76634,1192,13119,146,2640,13433,429347,103930,368732,34120,121445,97441,115726,505361,27916,13360,64498,468696,347510,174730,90433,82347,2013
40109,Oklahoma County, Oklahoma,738345,360118,378227,188683,459020,90642,692604,512006,107780,24027,23037,483,25271,45741,596913,141432,481564,70646,122120,146047,142751,657236,81109,25956,101518,633967,477827,251724,116406,109697,2013
40143,Tulsa County, Oklahoma,612322,298485,313837,155472,379740,77110,559807,437923,59711,26436,15424,345,19968,52515,503352,108970,400763,44258,104680,128954,122871,562292,50030,16960,80450,531690,396080,211277,96367,88436,2013
41051,Multnomah County, Oregon,750599,370125,380474,149065,514709,86825,711240,586981,40476,6359,50064,4165,23195,39359,540784,209815,541642,54051,97276,162901,227414,639516,111083,45995,105385,644851,529065,240353,174341,114371,2013
41067,Washington County, Oregon,549420,271276,278144,135278,351656,62486,525945,440933,10752,3443,49660,2801,18356,23475,455594,93826,368588,36873,75075,116855,139785,457561,91859,39655,56582,492719,366369,182953,108722,74694,2013
42003,Allegheny County, Pennsylvania,1197745,575867,621878,232316,762043,203386,1172194,975085,154882,1416,36992,69,3750,25551,909902,287843,866155,52414,252234,222587,338920,1127911,69834,31147,159834,1037590,789639,410915,215973,162751,2013
42045,Delaware County, Pennsylvania,540434,257275,283159,124405,335646,80383,529891,383225,110785,630,27515,46,7690,10543,457869,82565,370253,28859,118452,89459,133483,488710,51724,26954,63631,476803,350735,176853,91276,82606,2013
42071,Lancaster County, Pennsylvania,514196,250147,264049,126537,307180,80479,505712,455076,22211,1071,9860,0,17494,8484,441488,72708,344063,55742,128642,69611,90068,489371,24825,13604,55299,458592,321178,167194,90393,63591,2013
42091,Montgomery County, Pennsylvania,790802,383495,407307,178300,487974,124528,774011,644496,67038,449,54850,67,7111,16791,669084,121718,555483,33011,136514,122679,263279,707116,83686,45985,80426,710148,508976,276963,136874,95139,2013
42101,Philadelphia County, Pennsylvania,1510294,713415,796879,340410,984038,185846,1472811,622029,657011,3188,102845,375,87363,37483,1121796,388498,1010937,177057,345812,230749,257319,1315663,194631,93071,237290,1272893,1018607,429704,248010,340893,2013
44007,Providence County, Rhode Island,601768,293228,308540,130541,387974,83253,585203,435739,59248,2669,21743,291,65513,16565,493514,108254,412654,74369,116188,108631,113466,494448,107320,51747,80071,521236,404217,183971,119399,100847,2013
47037,Davidson County, Tennessee,637715,307489,330226,140555,428088,69072,623212,397599,174091,2245,20701,350,28226,14503,480930,156785,440368,56079,102664,114800,166825,560955,76760,28089,75095,562211,441098,231696,120106,89296,2013
47157,Shelby County, Tennessee,922086,438107,483979,237959,581476,102651,907921,372911,485619,1223,22841,414,24913,14165,767261,154825,592563,82406,154236,177544,178377,862855,59231,18926,121837,798935,608688,291484,152427,164777,2013
48029,Bexar County, Texas,1783867,875194,908673,471975,1116149,195743,1731021,1410083,128559,10336,45584,2396,134063,52846,1519945,263922,1129736,181810,299162,345117,303647,1549063,234804,88872,240110,1535801,1166263,572524,306596,287143,2013
48085,Collin County, Texas,850829,418708,432121,234537,538564,77728,825257,628837,78036,3288,101882,504,12710,25572,747385,103444,549284,33660,87851,157164,270609,700425,150404,72217,57149,793114,567140,325912,127489,113739,2013
48113,Dallas County, Texas,2450372,1208939,1241433,665935,1555928,228509,2387461,1443685,541735,6565,138373,1121,255982,62911,2064413,385959,1547391,341437,340693,407518,457743,1868620,581752,164017,235479,2214034,1622941,847149,390953,384839,2013
48121,Denton County, Texas,715471,353041,362430,190242,466331,58898,690853,558944,61023,2627,51082,573,16604,24618,613986,101485,461133,39960,88187,142881,190105,608030,107441,39754,57482,657544,487175,277826,121676,87673,2013
48141,El Paso County, Texas,812287,394210,418077,237585,486206,88496,797077,685377,26141,5653,8966,1148,69792,15210,734336,77951,482590,121645,112087,147408,101450,596196,216091,86765,106636,693034,513320,231548,123666,158106,2013
48157,Fort Bend County, Texas,646799,316547,330252,183797,405842,57160,632443,340392,134270,552,118566,0,38663,14356,599945,46854,408681,45758,68681,109207,185035,476703,170096,92720,49123,597645,428207,234659,93206,100342,2013
48201,Harris County, Texas,4290782,2134764,2156018,1171393,2737090,382299,4190485,2723314,802188,22581,274851,2448,365103,100297,3685726,605056,2700661,542084,640343,710546,807688,3200313,1090469,361930,401664,3888388,2862190,1483808,681834,696548,2013
48215,Hidalgo County, Texas,803934,391039,412895,274965,448885,80084,797820,737758,4620,1374,8407,0,45661,6114,751009,52925,440438,168796,101285,97953,72404,570567,233367,54471,97288,706543,477490,189830,127090,160570,2013
48439,Tarrant County, Texas,1886000,925923,960077,516289,1186221,183490,1820611,1304909,286056,9381,88254,2562,129449,65389,1618595,267405,1194849,175909,280160,372102,366678,1590888,295112,107879,200811,1683239,1242726,668821,299993,273912,2013
48453,Travis County, Texas,1096344,554536,541808,256556,751162,88626,1062852,855181,87213,4653,65122,666,50017,33492,821407,274937,736516,87046,126614,182762,340094,896433,199911,64441,109418,986556,775015,424801,209240,140974,2013
49035,Salt Lake County, Utah,1064922,533568,531354,302090,663198,99634,1038397,871118,16917,7912,38330,17660,86460,26525,923460,141462,658147,65677,150324,232449,209697,933070,131852,48732,99441,964809,694896,358333,198218,138345,2013
49049,Utah County, Utah,538728,271207,267521,190528,309921,38279,526056,491650,3953,3017,7872,4901,14663,12672,484854,53874,264950,16910,41492,104726,101822,499705,39023,13241,43541,494686,327320,131798,122016,73506,2013
51059,Fairfax County, Virginia,1120638,555507,565131,268578,728447,123613,1075810,712988,107702,1988,206412,978,45742,44828,965220,155418,765463,60139,99053,145858,460413,782753,337885,178415,73956,1037750,756542,439262,186673,130607,2013
53033,King County, Washington,2016073,1007034,1009039,425483,1352917,237673,1902363,1395185,123348,16455,310104,15377,41894,113710,1552203,463870,1422561,107899,234813,393114,686735,1580791,435282,207918,195475,1818043,1397811,719460,404149,274202,2013
53053,Pierce County, Washington,802110,397371,404739,194543,509635,97932,749339,601466,55328,9934,49981,11006,21624,52771,668887,133223,533892,52874,147131,197802,136085,721694,80416,40560,111169,677519,532584,253479,143407,135698,2013
53061,Snohomish County, Washington,737318,368166,369152,172161,479947,85210,702887,585428,20341,8630,71336,3611,13541,34431,616096,121222,501387,42513,116126,190926,151822,629356,107962,60003,90285,645471,499371,247750,138827,112794,2013
55025,Dane County, Wisconsin,497091,246412,250679,107027,333324,56740,484860,422990,25344,1167,25706,340,9313,12231,362084,135007,329955,17943,60309,93748,157955,457082,40009,12812,47332,449513,344574,183458,114833,46283,2013
55079,Milwaukee County, Wisconsin,933062,448286,484776,230559,592034,110469,901211,582876,244453,4205,34617,76,34984,31851,720136,212926,613039,82215,172255,175944,182625,850294,82768,34665,125454,807388,615902,285771,179402,150729,2013
1073,Jefferson County, Alabama,645501,304442,341059,150808,402901,91792,636470,339218,270607,2080,10475,284,13806,9031,527332,118169,440684,46079,123193,135754,135658,622037,23464,7744,100198,544989,420346,202922,99679,117745,2014
4013,Maricopa County, Arizona,4032398,1988616,2043782,1009107,2463710,559581,3901444,3188844,204690,74318,159823,8807,264962,130954,3335732,696666,2646142,347329,605915,887237,805661,3424308,608090,224659,441592,3587247,2577017,1290156,630638,656223,2014
4019,Pima County, Arizona,974855,473899,500956,213864,585687,175304,933345,759241,30690,31459,25897,1856,84202,41510,772748,202107,648850,76098,147964,222277,202511,844018,130837,60474,148541,822063,609922,272807,184702,152413,2014
6001,Alameda County, California,1583652,776796,806856,341841,1045014,196797,1488765,702051,181722,10446,444785,13140,136621,94887,1305841,277811,1108245,143075,202646,285410,477114,1074859,508793,265265,152554,1429510,1082273,529088,296763,256422,2014
6013,Contra Costa County, California,1101741,537124,564617,256902,689429,155410,1028531,653928,92678,5146,172302,5433,99044,73210,947037,154704,751368,83348,142140,226628,299252,831148,270593,141269,121801,979474,718344,335087,206892,176365,2014
6019,Fresno County, California,949344,470287,479057,275309,568059,105976,914135,575847,47738,8183,95399,2230,184738,35209,836034,113310,571245,148945,131979,176605,113716,745104,204240,80802,124240,824488,596575,233631,173107,189837,2014
6029,Kern County, California,841935,418746,423189,253448,503596,84891,810036,643278,40987,10239,39312,716,75504,31899,756452,85483,495770,123455,135960,157201,79154,677006,164929,53023,93951,746971,531729,218729,139328,173672,2014
6037,Los Angeles County, California,9964447,4902749,5061698,2273054,6485429,1205964,9576440,5236525,810737,62342,1426542,28440,2011854,388007,8425354,1539093,6691505,1500092,1390679,1759074,2041660,6470276,3494171,1737533,984316,8977225,6756813,3115629,1771228,1869956,2014
6059,Orange County, California,3108399,1534929,1573470,710876,1989673,407850,2983551,1958032,49807,13776,595139,8926,357871,124848,2698290,410109,2096391,321644,365270,610473,799004,2157526,950873,491016,268829,2838065,2071317,1006486,566334,498497,2014
6065,Riverside County, California,2296989,1135975,1161014,603980,1388719,304290,2200396,1459432,141077,20915,144754,5520,428698,96593,2043314,253675,1457188,280153,385302,487407,304326,1785947,511042,233289,256090,2037133,1460501,605681,397712,457108,2014
6067,Sacramento County, California,1458671,706896,751775,355416,917329,185926,1366671,862370,143109,10073,226594,16250,108275,92000,1220936,237735,964873,122504,216149,344475,281745,1158188,300483,171168,196140,1260548,957394,417420,261804,278170,2014
6071,San Bernardino County, California,2053110,1007522,1045588,562421,1277328,213361,1972990,1257767,163849,18788,141585,6493,384508,80120,1843196,209914,1263478,265489,337003,417123,243863,1601704,451406,217297,223345,1823127,1346602,560010,343255,443337,2014
6073,San Diego County, California,3183055,1581145,1601910,718668,2055918,408469,3018070,2256173,151827,14928,373113,14002,208027,164985,2649596,533459,2142724,283634,400234,657309,801547,2432799,750256,371113,306477,2839770,2138655,1024313,555055,559287,2014
6075,San Francisco County, California,838424,428242,410182,112646,605481,120297,797491,397244,44770,2268,286453,3665,63091,40933,543062,295362,667383,78531,84195,140882,363775,548287,290137,181871,87641,750558,615476,329461,173289,112726,2014
6077,San Joaquin County, California,703015,347437,355578,196291,425380,81344,644937,388376,50830,4298,108353,4193,88887,58078,614041,88974,436928,98083,120793,137199,80853,536046,166969,78510,81099,621220,448329,182825,125884,139620,2014
6081,San Mateo County, California,752109,368914,383195,160250,482062,109797,715678,397369,18905,2463,205339,9776,81826,36431,632709,119400,535905,63392,82121,134615,255777,485053,267056,147797,65813,686076,499326,270661,132388,96277,2014
6085,Santa Clara County, California,1864887,935482,929405,431899,1205940,227048,1781260,892314,46571,7537,644730,7111,182997,83627,1599961,264926,1283434,160743,197809,301820,623062,1145000,719887,382990,141879,1722580,1251501,649334,318666,283501,2014
6097,Sonoma County, California,494238,242330,251908,101967,311319,80952,467945,371772,7232,6748,19669,2210,60314,26293,399518,94720,350074,43216,67452,117243,122163,414403,79835,33854,59294,434580,322973,141000,114900,67073,2014
6099,Stanislaus County, California,526121,260544,265577,142556,320986,62579,504627,402123,12594,4034,29371,3588,52917,21494,466017,60104,329510,70788,89981,112255,56486,413523,112598,45560,72275,453747,337969,135588,91458,110923,2014
6111,Ventura County, California,834832,412228,422604,201126,520182,113524,798396,672949,13143,7860,59762,1661,43021,36436,736115,98717,553837,90732,107432,180601,175072,642241,192591,91625,90335,743428,543364,253159,159526,130679,2014
8005,Arapahoe County, Colorado,613882,302923,310959,149630,392473,71779,586566,442624,64185,4152,32640,1240,41725,27316,515365,98517,411323,33101,81990,127413,168819,519565,94317,42405,60318,552791,408148,225188,106067,76893,2014
8031,Denver County, Colorado,650761,325681,325080,136998,443346,70417,628706,511216,60688,7020,24155,174,25453,22055,452274,198487,462197,66563,79571,109414,206649,538676,112085,40619,61471,589060,453518,252256,117993,83269,2014
8041,El Paso County, Colorado,645274,322376,322898,163677,406830,74767,606184,510399,37324,3338,18788,1417,34918,39090,546005,99269,418013,29981,83798,150932,153302,601380,43894,20869,78220,549649,423779,211758,121259,90762,2014
9001,Fairfield County, Connecticut,927012,451765,475247,219221,576673,131118,904771,680658,100799,2022,48561,203,72528,22241,795914,131098,631454,63603,138488,131642,297721,729838,197174,86964,80077,846408,604168,303480,174732,125956,2014
9003,Hartford County, Connecticut,873790,421617,452173,192576,546764,134450,847862,636563,115800,2303,43728,596,48872,25928,727254,146536,607736,62914,164451,152431,227940,746099,127691,67357,106294,766796,570331,293427,161874,115030,2014
9009,New Haven County, Connecticut,834738,402589,432149,179897,526268,128573,809579,624013,105273,801,30274,126,49092,25159,673869,160869,582931,59887,179745,140097,203202,738559,96179,43894,96109,738387,548974,267504,153314,128156,2014
10003,New Castle County, Delaware,536246,257549,278697,120983,341613,73650,524005,346714,130720,1150,28885,197,16339,12241,440272,95974,366628,34126,103008,96012,133482,479487,56759,27078,59506,476128,356046,186031,89429,80586,2014
11001,District of Columbia, District of Columbia,624327,295954,328373,113123,439224,71980,609029,249670,307045,1859,22074,172,28209,15298,395145,229182,455801,44280,80615,77707,253199,537376,86951,33319,75040,547440,450068,251675,101281,97112,2014
12009,Brevard County, Florida,550448,268413,282035,102286,324119,124043,536342,456266,58692,1616,13432,526,5810,14106,447611,102837,406924,33806,119824,142504,110790,504084,46364,27412,83165,466194,336604,151258,83480,101866,2014
12011,Broward County, Florida,1853237,898852,954385,398044,1172115,283078,1797677,1167192,513741,5733,68639,1089,41283,55560,1534299,318938,1298875,149010,371170,381439,397256,1249426,603811,356872,214661,1637407,1217689,619808,311619,286262,2014
12031,Duval County, Florida,875816,419970,455846,200230,563692,111894,850890,533426,263828,2068,39846,288,11434,24926,705067,170749,597382,64074,177015,198964,157329,787473,88343,48106,123708,746438,585740,284728,148199,152813,2014
12057,Hillsborough County, Florida,1296661,632329,664332,301229,825548,169884,1255008,907029,214134,3406,48843,1085,80511,41653,1042625,254036,878378,110340,239210,266157,262671,1082935,213726,105561,143666,1147484,860512,438789,208307,213416,2014
12071,Lee County, Florida,668181,327124,341057,124670,366782,176729,656867,569958,58392,1331,10545,732,15909,11314,545205,122976,495829,67120,149924,146457,132328,559841,108340,46933,91576,576583,381801,175385,97576,108840,2014
12086,Miami-Dade County, Florida,2621175,1266335,1354840,542110,1680875,398190,2585704,1997835,480972,2905,41384,631,61977,35471,2263196,357979,1843091,347070,517587,483363,495071,1258864,1362311,760432,270754,2348974,1743547,884326,369410,489811,2014
12095,Orange County, Florida,1221051,598372,622679,280679,808087,132285,1183114,796003,253705,2646,64030,623,66107,37937,995751,225300,815225,96914,203658,256065,258588,964848,256203,122273,126529,1094424,838352,423754,213712,200886,2014
12099,Palm Beach County, Florida,1378538,665345,713193,267970,798098,312470,1353603,1035427,246699,2046,36936,558,31937,24935,1099129,279409,1002982,121290,260437,288031,333224,1039518,339020,165062,171040,1207253,829914,411775,221428,196711,2014
12103,Pinellas County, Florida,923422,442717,480705,157665,556975,208782,899820,762094,95492,2484,28736,927,10087,23602,680518,242904,700864,67320,199754,225340,208450,816543,106879,62630,141974,780828,575133,289587,134996,150550,2014
12105,Polk County, Florida,620664,302019,318645,141740,356703,122221,606750,486471,93622,1660,9824,361,14812,13914,531599,89065,427994,63245,160284,119140,85325,559709,60955,25890,90715,529949,373471,175117,81181,117173,2014
12127,Volusia County, Florida,497358,242342,255016,89496,292621,115241,488572,419391,49738,2402,8953,160,7928,8786,395994,101364,368123,40442,126998,117287,83396,454449,42909,22466,76220,420913,304407,133372,76287,94748,2014
13067,Cobb County, Georgia,719932,347410,372522,177503,466399,76030,702314,428843,194851,886,36298,794,40642,17618,609535,110397,479413,45914,94339,128300,210860,605047,114885,47949,62832,656615,483972,259542,129047,95383,2014
13089,DeKalb County, Georgia,706513,335224,371289,167226,466961,72326,690507,249851,379795,1711,39332,116,19702,16006,555410,151103,479516,54924,100727,122617,201248,590893,115620,44272,73192,632519,484750,242745,130069,111936,2014
13121,Fulton County, Georgia,963999,463520,500479,229327,633435,101237,946482,444140,424747,2143,61156,477,13819,17517,736983,227016,652802,55372,120812,152738,323880,851762,112237,48691,99534,864177,657243,343967,157477,155799,2014
13135,Gwinnett County, Georgia,872040,424999,447041,243232,554378,74430,847961,456809,221823,4569,98979,341,65440,24079,785560,86480,549528,65201,127152,161902,195273,656301,215739,96584,65825,805434,582398,295258,145823,141317,2014
15003,Honolulu County, Hawaii,959920,481059,478861,209673,596661,153586,744474,201997,24214,875,414441,94424,8523,215446,833757,126163,662682,53750,176354,213554,219024,777274,182646,106851,105893,827533,618440,340738,150513,127189,2014
17031,Cook County, Illinois,5158823,2499247,2659576,1172143,3329387,657293,5043378,2914322,1225483,13713,361712,1586,526562,115445,4178918,979905,3525236,501097,838815,897889,1287435,4069631,1089192,536558,536859,4620801,3456514,1704912,878084,873518,2014
17043,DuPage County, Illinois,919513,451751,467762,216550,581554,121409,897480,729989,42437,1129,103725,231,19969,22033,797306,122207,625972,47088,116877,159808,302199,743527,175986,98335,75997,843347,607457,326377,164435,116645,2014
17089,Kane County, Illinois,519507,259053,260454,139134,319600,60773,507944,375026,28686,2082,19059,36,83055,11563,462490,57017,334964,56338,77203,91228,110195,423966,95541,37698,42820,476647,337488,171564,97264,68660,2014
17097,Lake County, Illinois,686357,338365,347992,177030,426123,83204,669351,563258,44756,890,48185,866,11396,17006,606603,79754,448690,43004,99002,107730,198954,554037,132320,67472,58915,626216,447707,232740,122615,92352,2014
17197,Will County, Illinois,674552,332957,341595,180416,419978,74158,655878,494898,70093,2326,35766,82,52713,18674,611641,62911,433466,38646,114973,134669,145178,594654,79898,42962,57275,617056,442874,231713,120613,90548,2014
18097,Marion County, Indiana,913017,439648,473369,226308,584794,101915,888857,582850,248400,1665,23837,1259,30846,24160,707143,205874,601294,88084,174543,163753,174914,831839,81178,24946,137325,775583,606630,294877,172919,138834,2014
20173,Sedgwick County, Kansas,501712,247743,253969,133094,305353,63265,482879,397392,46249,4895,21911,75,12357,18833,421773,79939,322549,35729,83911,103065,99844,458724,42988,18948,59214,440876,320361,165191,83902,71268,2014
21111,Jefferson County, Kentucky,743380,359663,383717,168621,468360,106399,723306,542238,156315,1589,19095,491,3578,20074,583427,159953,513706,57643,137837,154269,163957,686359,57021,22366,113675,629346,485208,250200,125235,109773,2014
24005,Baltimore County, Maryland,805749,382719,423030,175250,504330,126169,786323,504225,223085,1564,47535,349,9565,19426,665641,140108,564239,53794,155019,143959,211467,702894,102855,56531,94183,711235,523653,287422,126748,109483,2014
24031,Montgomery County, Maryland,1022346,492657,529689,239856,644802,137688,982855,556616,182509,2993,151458,468,88811,39491,872362,149984,702572,63847,91167,135360,412198,680675,341671,172493,80427,939070,671033,373010,181778,116245,2014
24033,Prince George's County, Maryland,882402,424593,457809,200526,581558,100318,859678,191641,558977,2700,37148,39,69173,22724,744368,138034,599131,86445,156195,170383,186108,687635,194767,77605,82667,797553,602105,334753,144668,122684,2014
24510,Baltimore city, Maryland,598509,280312,318197,129789,394669,74051,585998,180467,377332,1502,15783,108,10806,12511,440223,158286,414424,63419,130760,93891,126354,550955,47554,18858,89451,508810,407402,187303,97503,122596,2014
25005,Bristol County, Massachusetts,538758,261008,277750,115770,340101,82887,524270,462281,21426,1241,11088,0,28234,14488,451030,87728,377735,65473,116353,97672,98237,468496,70262,45556,76524,462115,353248,175978,104494,72776,2014
25009,Essex County, Massachusetts,753212,364196,389016,166923,471045,115244,734569,591754,25639,2894,27164,0,87118,18643,635537,117675,521465,55952,129018,132049,204446,630436,122776,63599,89278,663767,492450,251666,140985,99799,2014
25017,Middlesex County, Massachusetts,1513368,736649,776719,319595,981309,212464,1468042,1196907,71502,2519,162049,310,34755,45326,1206835,306533,1079015,81062,221521,207270,569162,1215894,297474,146272,138172,1373494,1018127,549721,289618,178788,2014
25025,Suffolk County, Massachusetts,723337,352756,370581,131444,510983,80910,677714,400469,163266,2361,60152,59,51407,45623,490008,233329,515162,82427,117725,96637,218373,509217,214120,102452,97950,624981,524248,261153,147472,115623,2014
25027,Worcester County, Massachusetts,786625,385147,401478,174746,501781,110098,762230,673038,35562,1509,36145,136,15840,24395,657817,128808,543919,53236,161266,138765,190652,689674,96951,50426,92980,693366,523534,266034,148458,109042,2014
26081,Kent County, Michigan,618458,303502,314956,154886,389480,74092,598289,496710,59998,3912,16380,346,20943,20169,509948,108510,405321,43723,102353,122022,137223,571522,46936,19048,75073,543317,407930,197368,129060,81502,2014
26099,Macomb County, Michigan,852132,413657,438475,186132,535328,130672,832963,703534,90811,2052,31845,0,4721,19169,714125,138007,591861,62391,179260,207855,142355,763436,88696,55695,120533,731303,558024,272769,152208,133047,2014
26125,Oakland County, Michigan,1227353,596204,631149,270931,773822,182600,1195378,931936,169655,2975,81090,236,9486,31975,1012123,215230,857214,54172,168051,249146,385845,1075075,152278,83380,150710,1076164,807048,412701,220126,174221,2014
26163,Wayne County, Michigan,1745528,837064,908464,419843,1088036,237649,1709916,935943,680149,6747,52877,261,33939,35612,1444471,301057,1155446,172656,352408,373596,256786,1598186,147342,82021,283927,1461500,1137139,458621,304433,374085,2014
27053,Hennepin County, Minnesota,1187656,583519,604137,264068,777404,146184,1148712,882062,146390,7050,83136,640,29434,38944,891980,295676,825926,55074,144836,232576,393440,1024163,163493,78474,116398,1070763,805653,443572,237666,124415,2014
27123,Ramsey County, Minnesota,519368,252634,266734,123457,329432,66479,499821,352598,59423,4022,72319,168,11291,19547,404353,115015,347535,34733,74233,95340,143229,442957,76411,40810,67111,451857,342564,169823,107974,64767,2014
29095,Jackson County, Missouri,672595,326446,346149,161359,422532,88704,651001,439088,160527,2718,12878,918,34872,21594,524231,148364,453434,44836,133160,140561,134877,635445,37150,16391,92279,580250,439502,228341,110122,101039,2014
29189,St. Louis County, Missouri,981184,463577,517607,219395,605404,156385,958178,682488,232289,1650,36779,167,4805,23006,807834,173350,679047,43746,145918,195128,294255,915048,66136,33750,116703,864395,632019,333655,167683,130681,2014
31055,Douglas County, Nebraska,531665,263111,268554,138224,332886,60555,516362,426113,59146,4501,16793,458,9351,15303,423734,107931,347577,40115,76455,103737,127270,483149,48516,15259,55283,475808,346788,194855,92632,59301,2014
32003,Clark County, Nevada,2044680,1018924,1025756,485252,1286984,272444,1947380,1280644,223741,10168,192284,14038,226505,97300,1677241,367439,1377522,211875,390174,460520,314953,1587985,456695,211164,262551,1776700,1341187,653149,345326,342712,2014
34003,Bergen County, New Jersey,922622,447558,475064,201222,575947,145453,903361,645618,54004,1613,148938,137,53051,19261,811151,111471,650160,53767,164229,130278,301886,637343,285279,180126,73726,848675,601376,323213,147331,130832,2014
34007,Camden County, New Jersey,502540,242528,260012,116158,315959,70423,492400,311489,98292,1445,29283,146,51745,10140,425710,76830,342249,39306,108589,86105,108249,445232,57308,30604,69489,432563,329169,166507,89159,73503,2014
34013,Essex County, New Jersey,776945,370473,406472,189481,492476,94988,760570,320230,309197,2240,38573,225,90105,16375,648565,128380,517905,73624,148693,123558,172030,577240,199705,104317,100308,676558,513557,247814,135035,130708,2014
34017,Hudson County, New Jersey,662812,329116,333696,135075,457890,69847,647182,380047,87014,698,99275,303,79845,15630,520640,142172,469183,77256,123474,87996,180457,381262,281550,136372,61156,601335,472011,251590,110639,109782,2014
34023,Middlesex County, New Jersey,806690,394461,412229,182003,516025,108662,791534,487454,77472,1430,191617,400,33161,15156,708300,98390,561616,60945,144364,122738,233569,538883,267807,139702,72488,733965,537427,293146,124817,119464,2014
34029,Ocean County, New Jersey,579659,279377,300282,136759,317555,125345,570254,532677,17253,165,11503,163,8493,9405,493815,85844,399315,32609,134116,117606,114984,530569,49090,26350,81896,497389,331136,158438,94137,78561,2014
34031,Passaic County, New Jersey,500680,244389,256291,123031,313329,64320,482822,290733,60114,3080,27528,51,101316,17858,446250,54430,329736,52759,109563,72315,95099,357720,142960,89429,45176,455248,326464,166707,63251,96506,2014
34039,Union County, New Jersey,546275,266360,279915,130900,346247,69128,535000,311984,115220,328,28079,0,79389,11275,481403,64872,367961,50329,109047,86166,122419,379782,166493,84279,50083,496192,360929,186677,95745,78507,2014
35001,Bernalillo County, New Mexico,667836,326001,341835,153600,419733,94503,636928,484301,17796,31258,16279,182,87112,30908,542411,125425,451030,53623,109154,140552,147701,598023,69813,28088,90678,575413,436188,209775,111492,114921,2014
36005,Bronx County, New York,1401392,654531,746861,357707,891192,152493,1359458,275477,463157,7510,54035,928,558351,41934,1196033,205359,887973,258468,241792,214474,173239,905753,495639,228591,190322,1210991,930810,396733,208210,325867,2014
36029,Erie County, New York,894978,431978,463000,186796,561385,146797,874026,703550,118474,4336,27257,360,20049,20952,700806,194172,627654,56968,175418,196031,199237,835034,59944,27642,120889,773658,584851,288912,169652,126287,2014
36047,Kings County, New York,2597659,1231199,1366460,601870,1683871,311918,2534672,1112605,867229,7657,307619,720,238842,62987,2105034,492625,1753701,348937,454128,347420,603216,1632043,965616,558623,272797,2324170,1747469,817465,421660,508344,2014
36055,Monroe County, New York,727249,350573,376676,159148,456162,111939,704704,552568,111837,4022,23452,61,12764,22545,570486,156763,502354,48093,125912,146814,181535,668941,58308,32575,93421,633747,474635,235626,137111,101898,2014
36059,Nassau County, New York,1338841,650211,688630,297337,824723,216781,1292033,928461,153052,2740,116904,0,90876,46808,1209038,129803,927975,85024,217387,222284,403280,1044279,294562,179863,114926,1223606,864034,450423,216703,196908,2014
36061,New York County, New York,1589189,753080,836109,236709,1122967,229513,1520077,882722,234571,8117,186021,165,208481,69112,990356,598833,1226844,160191,155254,172799,738600,1121604,467585,226775,169292,1419249,1144663,622786,270061,251816,2014
36081,Queens County, New York,2296519,1114848,1181671,466195,1524600,305724,2224651,934290,423254,8821,575244,1062,281980,71868,1954043,342476,1626620,314921,446515,377574,487610,1192573,1103946,612430,218255,2078014,1573607,789495,365720,418392,2014
36103,Suffolk County, New York,1471739,722760,748979,328087,923058,220594,1434852,1187902,113299,4141,51023,180,78307,36887,1306222,165517,1013012,101055,297629,266563,347765,1243016,228723,118512,142494,1328839,962965,493141,247471,222353,2014
36119,Westchester County, New York,949269,459797,489472,219624,583111,146534,921505,633207,133740,6407,57084,18,91049,27764,820630,128639,653607,80255,128288,133273,311791,700472,248797,123929,88559,860599,607912,307512,165792,134608,2014
37081,Guilford County, North Carolina,496471,236950,259521,114817,313263,68391,486534,283434,164303,2100,21690,206,14801,9937,398383,98088,335281,36878,85206,100997,112200,444136,52335,18276,54646,441438,326439,159796,82944,83699,2014
37119,Mecklenburg County, North Carolina,997439,478775,518664,246395,651486,99558,966331,556871,305242,2599,52250,390,48979,31108,805930,191509,663822,69161,120195,187360,287106,854037,143402,50981,96027,900780,676737,363305,179710,133722,2014
37183,Wake County, North Carolina,976011,475098,500913,247250,631482,97279,947743,654289,196059,3256,61962,515,31662,28268,805127,170884,648300,48214,107237,171334,321515,849813,126198,52126,80202,895032,658279,368557,170234,119488,2014
39035,Cuyahoga County, Ohio,1233260,587289,645971,266903,767068,199289,1202159,777056,369076,4064,35256,85,16622,31101,955425,277835,859791,100682,238338,251260,269511,1147726,85534,49499,185096,1048027,799528,384457,222376,192695,2014
39049,Franklin County, Ohio,1202646,585978,616668,287561,785135,129950,1156469,825580,259582,1343,53092,167,16705,46177,936893,265753,806029,79099,196910,222203,307817,1082757,119889,50229,132023,1070339,813270,437300,219359,156611,2014
39061,Hamilton County, Ohio,788603,380568,408035,184681,495020,108902,769602,538719,203668,614,17677,86,8838,19001,607998,180605,533225,49045,144128,148183,191869,749504,39099,14301,102886,685587,514676,253267,152629,108780,2014
39113,Montgomery County, Ohio,518240,248991,269249,118534,314739,84967,503631,378884,109807,1712,9806,52,3370,14609,407846,110394,356563,35984,101321,126895,92363,496396,21844,11802,77596,438563,328325,156035,91199,81091,2014
39153,Summit County, Ohio,533629,258099,275530,116529,332678,84422,520076,424154,76576,1334,14609,62,3341,13553,430530,103099,370734,32026,119028,106482,113198,510524,23105,12280,65065,468507,347455,177141,92506,77808,2014
40109,Oklahoma County, Oklahoma,747984,363254,384730,191868,463170,92946,696131,518195,112431,19300,25831,656,19718,51853,606042,141942,487452,62039,120211,154111,151091,664328,83656,23070,105268,639376,483033,250067,122895,110071,2014
40143,Tulsa County, Oklahoma,619330,301274,318056,157618,381665,80047,568362,437258,61210,27741,16217,813,25123,50968,505644,113686,406059,45338,103839,131470,125412,566659,52671,15620,83476,535637,397888,218167,96462,83259,2014
41051,Multnomah County, Oregon,761305,376894,384411,149309,521445,90551,719317,587765,38892,6834,51526,4631,29669,41988,549724,211581,552039,48533,100775,171747,230984,652662,108643,49139,108864,652380,534506,246725,179017,108764,2014
41067,Washington County, Oregon,556618,274295,282323,135139,355454,66025,531361,429309,10414,4255,53380,1960,32043,25257,466008,90610,376311,36252,74088,115742,150229,464207,92411,38950,57270,498884,370310,182253,110868,77189,2014
42003,Allegheny County, Pennsylvania,1197235,577288,619947,231486,759155,206594,1169294,968322,153806,1488,39037,225,6416,27941,913712,283523,869918,50880,257673,229158,332207,1132736,64499,30415,161641,1035267,786648,411798,214843,160007,2014
42045,Delaware County, Pennsylvania,541904,257940,283964,123696,336176,82032,532370,385024,114266,730,28861,239,3250,9534,462360,79544,372712,30809,115508,89560,136835,488146,53758,29647,66174,475489,350845,171883,95434,83528,2014
42071,Lancaster County, Pennsylvania,519532,253882,265650,127365,308594,83573,510748,456849,21880,1266,11150,0,19603,8784,442092,77440,349126,51975,132389,73015,91747,492224,27308,14721,63898,455444,322585,176558,84248,61779,2014
42091,Montgomery County, Pennsylvania,797060,387334,409726,177523,491886,127651,777654,642242,67387,731,57504,0,9790,19406,675526,121534,559666,33882,129834,126914,269036,710355,86705,49236,80007,716924,511613,286420,139276,85917,2014
42101,Philadelphia County, Pennsylvania,1515813,714760,801053,340932,985696,189185,1473412,639565,647922,7342,104505,897,73181,42401,1152719,363094,1024618,175786,354509,225574,268749,1316019,199794,97778,235961,1279758,1020713,436377,252218,332118,2014
44007,Providence County, Rhode Island,606305,293922,312383,131974,388991,85340,588630,449113,59421,3510,24839,258,51489,17675,490977,115328,416962,72997,126707,110650,106608,494813,111492,53665,83115,522842,403961,192270,111555,100136,2014
47037,Davidson County, Tennessee,648013,310120,337893,142496,433018,72499,633318,407096,177739,1985,20760,380,25358,14695,490840,157173,449301,58654,106088,115442,169117,563212,84801,27470,78356,569160,446861,236204,127047,83610,2014
47157,Shelby County, Tennessee,921562,437042,484520,237115,578504,105943,903469,368932,483828,1239,22817,413,26240,18093,760128,161434,593748,73069,168087,172880,179712,863457,58105,19326,118310,802152,604679,292801,152167,159711,2014
48029,Bexar County, Texas,1821199,891568,929631,479181,1137124,204894,1766047,1453039,136619,10993,48083,868,116445,55152,1547322,273877,1158547,194881,284448,374162,305056,1580699,240500,95847,251892,1558976,1189880,592174,307180,290526,2014
48085,Collin County, Texas,880671,432442,448229,238957,556797,84917,852743,633768,81524,3278,110541,665,22967,27928,779700,100971,571659,35895,86198,162772,286794,706979,173692,84039,60424,819739,584489,336369,136925,111195,2014
48113,Dallas County, Texas,2486437,1221791,1264646,669476,1578905,238056,2420841,1552207,549462,7813,143126,1404,166829,65596,2090434,396003,1577327,354120,363895,398738,460574,1893013,593424,169831,245425,2240598,1646797,866180,389919,390698,2014
48121,Denton County, Texas,740794,364417,376377,194899,481160,64735,715073,568987,64592,3124,54878,619,22873,25721,637525,103269,480736,38379,93709,148253,200395,634159,106635,46553,57695,682320,503400,286634,128133,88633,2014
48141,El Paso County, Texas,817939,396548,421391,233900,491943,92096,801425,687774,28918,4539,8596,610,70988,16514,736316,81623,490339,119004,123276,143386,104673,606123,211816,89541,114450,691397,518050,234358,125847,157845,2014
48157,Fort Bend County, Texas,679797,332523,347274,190949,424617,64231,665162,357554,139523,1976,129339,171,36599,14635,629762,50035,430780,47419,76427,115090,191844,500726,179071,95480,61127,618619,446278,242171,91110,112997,2014
48201,Harris County, Texas,4395224,2181890,2213334,1191651,2800313,403260,4303450,2779502,831358,20390,291623,3096,377481,91774,3742706,652518,2782897,560341,633738,758312,830506,3242999,1152225,382804,410831,3983247,2922862,1546150,684488,692224,2014
48215,Hidalgo County, Texas,820586,397469,423117,277918,458307,84361,814521,760817,4053,1603,8153,364,39531,6065,773798,46788,451534,169524,100802,99331,81877,593304,227282,60477,105538,715048,486839,190910,130045,165884,2014
48339,Montgomery County, Texas,513531,252568,260963,137403,314677,61451,502287,447162,22439,719,13875,641,17451,11244,454296,59235,332108,46203,70914,100791,114200,451483,62048,21927,59897,453130,330411,171199,76398,82814,2014
48439,Tarrant County, Texas,1919626,938272,981354,521062,1204972,193592,1861810,1352335,298523,8480,95860,3825,102787,57816,1646161,273465,1221469,181957,292658,377290,369564,1619575,300051,111460,193692,1724472,1261675,667498,310784,283393,2014
48453,Travis County, Texas,1128113,568872,559241,262061,771307,94745,1097200,873575,93768,4309,71486,413,53649,30913,840778,287335,765233,86456,132210,195748,350819,926375,201738,62140,95584,1031736,795375,442208,200348,152819,2014
49035,Salt Lake County, Utah,1077693,539624,538069,304378,669835,103480,1046442,873584,18233,8052,41524,17709,87340,31251,932378,145315,669230,69872,150947,233697,214714,941083,136610,53113,97533,979310,699981,374877,192671,132433,2014
49049,Utah County, Utah,548399,275714,272685,193796,314594,40009,533278,507233,3375,2397,7080,3609,9584,15121,499509,48890,270332,16508,47469,104311,102044,510607,37792,13345,40214,507899,332174,137171,125175,69828,2014
51059,Fairfax County, Virginia,1127943,558679,569264,269807,729562,128574,1078968,712698,107851,2706,213061,578,42074,48975,965549,162394,768950,64615,97923,141529,464883,777416,350527,180440,74947,1044627,759559,432097,194437,133025,2014
53033,King County, Washington,2050232,1025214,1025018,429374,1373325,247533,1925203,1388882,123834,14775,330411,15928,51373,125029,1582997,467235,1452547,110625,226558,406096,709268,1613428,436804,211732,207316,1840387,1419707,748147,394361,277199,2014
53053,Pierce County, Washington,814263,404159,410104,195259,516171,102833,751226,606664,53767,9361,48399,10750,22285,63037,672205,142058,542448,51411,152103,205125,133809,736554,77709,42271,111273,690859,537696,263150,134279,140267,2014
53061,Snohomish County, Washington,749765,375297,374468,173427,486878,89460,709671,590705,19360,7523,73041,3698,15344,40094,631704,118061,511097,40367,127486,192965,150279,639954,109811,55916,84098,662980,507994,258728,141583,107683,2014
55025,Dane County, Wisconsin,501698,248298,253400,107332,334482,59884,486514,420075,24350,1000,27583,16,13490,15184,380116,121582,333102,16363,58093,91044,167602,461224,40474,16589,47548,454023,346469,182555,117368,46546,2014
55079,Milwaukee County, Wisconsin,933752,449542,484210,230112,591505,112135,908367,576446,247950,6092,36430,203,41246,25385,727587,206165,617127,79139,174804,179672,183512,852334,81418,33427,127108,806428,614832,291746,175919,147167,2014
1073,Jefferson County, Alabama,646801,305749,341052,150721,402223,93857,638980,337444,277302,1221,10677,711,11625,7821,526534,120267,443626,46596,115743,139591,141696,618126,28675,8667,99422,546815,418752,211038,101002,106712,2015
4013,Maricopa County, Arizona,4115692,2028059,2087633,1015693,2513687,586312,3984131,3219492,222092,78638,165068,8086,290755,131561,3397509,718183,2720490,358807,624858,898140,838685,3506151,609541,235742,453448,3658292,2631761,1343442,634248,654071,2015
4019,Pima County, Arizona,981340,477409,503931,214046,583683,183611,944265,757568,34454,35876,27940,1374,87053,37075,775296,206044,656103,81097,149324,219342,206340,850669,130671,62169,152345,824552,609168,273822,179358,155988,2015
6001,Alameda County, California,1611546,791121,820425,340358,1066456,204732,1514072,688321,178693,10399,467515,14303,154841,97474,1326077,285469,1137965,140650,205694,276909,514712,1091533,520013,278401,160705,1449962,1101612,564815,289532,247265,2015
6013,Contra Costa County, California,1117233,545704,571529,257878,697650,161705,1050445,635122,98500,6082,181841,6111,122789,66788,965508,151725,765779,84496,137305,235125,308853,828544,288689,152514,127713,988954,727385,345943,206797,174645,2015
6019,Fresno County, California,957746,474841,482905,275247,573295,109204,925661,620280,45233,8998,98631,1851,150668,32085,838986,118760,581195,148288,134713,185409,112785,750060,207686,77292,126441,831203,602738,236342,186278,180118,2015
6029,Kern County, California,852490,425782,426708,254679,510604,87207,826848,664910,44883,7111,39641,2092,68211,25642,766020,86470,505223,131002,146870,142540,84811,678253,174237,59579,89640,760648,538064,239164,127887,171013,2015
6037,Los Angeles County, California,10021888,4931085,5090803,2251009,6521273,1249606,9663510,5207447,816177,70438,1446990,28629,2093829,358378,8480386,1541502,6794754,1480729,1435757,1770688,2107580,6530151,3491737,1789519,988851,9030669,6783767,3244397,1678342,1861028,2015
6059,Orange County, California,3130028,1546691,1583337,704323,2000797,424908,3017022,1958739,52285,13967,614974,9979,367078,113006,2699607,430421,2133056,338373,365381,600236,829066,2146463,983565,496920,270647,2856932,2085894,1022438,558518,504938,2015
6065,Riverside County, California,2324474,1152164,1172310,601320,1406815,316339,2227909,1468801,143485,18502,145732,6423,444966,96565,2060236,264238,1491913,290902,399763,489630,311618,1805590,518884,245007,261762,2059607,1480207,636838,394730,448639,2015
6067,Sacramento County, California,1482733,721335,761398,357089,930488,195156,1381593,890049,142571,8496,231939,16413,92125,101140,1237247,245486,990003,125179,220656,348465,295703,1176153,306580,177091,183183,1298673,969878,440691,260157,269030,2015
6071,San Bernardino County, California,2060954,1007072,1053882,559758,1278794,222402,1970936,1271881,167156,14248,147223,6721,363707,90018,1848897,212057,1280153,263929,340504,421994,253726,1607280,453674,219144,216458,1838183,1344905,582044,347968,414893,2015
6073,San Diego County, California,3222190,1600300,1621890,718413,2079224,424553,3066153,2279045,158545,16213,384552,13716,214082,156037,2655435,566755,2184633,291482,407641,667536,817974,2430226,791964,407351,322877,2867914,2158663,1037003,592318,529342,2015
6075,San Francisco County, California,851921,434738,417183,114856,612180,124885,814659,403143,43697,2911,298216,3472,63220,37262,549054,302867,679697,84084,86628,133598,375387,557213,294708,182547,91360,760287,624056,346438,167043,110575,2015
6077,San Joaquin County, California,712152,352652,359500,196238,431451,84463,638322,410759,46714,3458,108756,2560,66075,73830,633677,78475,446287,97317,117259,146641,85070,538393,173759,78480,86602,625218,453709,187905,124253,141551,2015
6081,San Mateo County, California,758891,373735,385156,160046,485936,112909,721625,386019,17993,2314,212469,10524,92306,37266,642746,116145,542415,64977,82116,138783,256539,488032,270859,155304,63649,695138,503369,262820,144708,95841,2015
6085,Santa Clara County, California,1887462,950376,937086,432017,1220260,235185,1799174,852404,45473,8392,660286,8950,223669,88288,1620486,266976,1305727,164670,191270,301235,648552,1158645,728817,385287,150843,1735899,1267745,666413,318227,283105,2015
6097,Sonoma County, California,494394,241766,252628,99297,308539,86558,462335,379508,7016,4290,18991,1058,51472,32059,394939,99455,353157,45125,67615,124225,116192,410886,83508,34155,63801,430096,319446,147372,105885,66189,2015
6099,Stanislaus County, California,532988,264633,268355,143577,324217,65194,511025,403071,14338,3860,30126,4218,55412,21963,469904,63084,336249,76578,95571,108564,55536,422448,110540,49058,71359,461321,340650,139684,92791,108175,2015
6111,Ventura County, California,840470,414247,426223,199371,522730,118369,806727,677994,14004,8135,61863,2030,42701,33743,740280,100190,560510,95032,103124,178489,183865,643775,196695,86668,89049,749971,546804,262089,159032,125683,2015
8005,Arapahoe County, Colorado,624005,305857,318148,150055,399094,74856,591272,447841,63233,2988,34734,1413,41063,32733,517361,106644,419917,28768,86033,131924,173192,533844,90161,37433,53100,569346,415405,233826,108513,73066,2015
8031,Denver County, Colorado,669669,334751,334918,139170,456692,73807,646062,516193,63381,6630,23077,474,36307,23607,473034,196635,477683,66728,76657,106858,227440,557480,112189,33328,59907,609307,467422,264488,118575,84359,2015
8041,El Paso County, Colorado,657934,329572,328362,165888,414116,77930,623676,519754,43908,3944,19424,2688,33958,34258,559399,98535,426840,23168,92678,154794,156200,608991,48943,25617,77677,563007,433782,219755,120067,93960,2015
9001,Fairfield County, Connecticut,929960,452884,477076,218229,578980,132751,898633,686707,107332,1052,48035,354,55153,31327,796885,133075,633294,61669,146007,130253,295365,728858,201102,93556,85609,844234,606620,301529,176303,128788,2015
9003,Hartford County, Connecticut,871498,421639,449859,189442,545440,136616,844027,629754,117823,2620,42812,0,51018,27471,723458,148040,608031,63311,161951,151786,230983,729471,142027,76246,100621,770534,568653,297204,153037,118412,2015
9009,New Haven County, Connecticut,833098,402804,430294,176118,525503,131477,811138,614882,109191,1692,35340,0,50033,21960,671646,161452,585522,59610,176239,146559,203114,726411,106687,47148,98554,734123,548601,279872,140986,127743,2015
10003,New Castle County, Delaware,539874,259683,280191,120749,342479,76646,524136,350526,130251,1252,29486,160,12461,15738,447844,92030,372914,32144,102385,102706,135679,477203,62671,28477,58446,481162,355938,189578,92037,74323,2015
11001,District of Columbia, District of Columbia,638027,303133,334894,116058,448292,73677,617973,252112,305616,1655,24129,475,33986,20054,407642,230385,465979,46235,79564,72852,267328,546329,91698,40699,74022,561660,457703,261259,106465,89979,2015
12009,Brevard County, Florida,560648,272910,287738,102337,329483,128828,544085,465593,56041,1979,12598,995,6879,16563,449980,110668,415316,34324,122046,140573,118373,512363,48285,29321,82117,477140,342740,162866,81136,98738,2015
12011,Broward County, Florida,1878979,910922,968057,401418,1184102,293459,1823044,1153750,533476,3758,67537,988,63535,55935,1555443,323536,1323832,153839,361881,379485,428627,1247329,631650,359486,202140,1676280,1230422,626767,326221,277434,2015
12031,Duval County, Florida,893025,430879,462146,204634,571225,117166,862234,545257,263365,1150,41713,1121,9628,30791,717958,175067,611204,67045,168130,197485,178544,805527,87498,51684,130059,756435,590325,309616,141078,139631,2015
12057,Hillsborough County, Florida,1329432,647734,681698,306576,844695,178161,1285586,931652,219356,3485,52297,875,77921,43846,1081052,248380,906472,106367,236100,268777,295228,1109510,219922,107307,158512,1164956,879127,454326,205932,218869,2015
12071,Lee County, Florida,691054,336439,354615,125978,378152,186924,677885,592860,59077,462,11120,280,14086,13169,566866,124188,518991,67351,161258,154389,135993,579531,111523,49943,96287,594263,392335,183770,90739,117826,2015
12086,Miami-Dade County, Florida,2653162,1278831,1374331,546186,1692903,414073,2613626,2009033,482279,1509,42004,310,78491,39536,2276246,376916,1878521,364351,537629,457520,519021,1245783,1407379,783398,273345,2379117,1756789,895459,367209,494121,2015
12095,Orange County, Florida,1255086,612806,642280,286192,830475,138419,1218751,804907,257595,2783,67447,1617,84402,36335,1028865,226221,843144,94195,216326,259336,273287,998798,256288,133804,138749,1116308,861430,450325,222836,188269,2015
12099,Palm Beach County, Florida,1403684,676604,727080,273302,808063,322319,1374090,1041004,252715,2400,36695,339,40937,29594,1142312,261372,1025798,114039,246067,296737,368955,1061372,342312,175015,175478,1227804,840331,422539,223682,194110,2015
12103,Pinellas County, Florida,935344,447877,487467,156989,562688,215667,910522,770056,95575,2749,32739,871,8532,24822,702828,232516,714166,62044,204255,232645,215222,822378,112966,59888,139896,794520,582031,300715,143096,138220,2015
12105,Polk County, Florida,636822,310147,326675,145259,366522,125041,621023,501351,94423,1843,11074,267,12065,15799,542519,94303,439038,71342,156021,126997,84678,572890,63932,26825,94324,542207,383063,182646,82971,117446,2015
12127,Volusia County, Florida,508830,247527,261303,91336,296524,120970,498813,427522,53778,1210,9105,477,6721,10017,404620,104210,378059,36070,126368,129913,85708,470236,38594,22472,83720,424951,307912,136029,77922,93961,2015
13067,Cobb County, Georgia,729957,352096,377861,179979,470639,79339,710292,434327,195657,1103,37507,496,41202,19665,620517,109440,488181,46909,92113,127414,221745,609941,120016,49905,62804,666905,490556,271945,121821,96790,2015
13089,DeKalb County, Georgia,722017,341852,380165,171374,474613,76030,707171,252359,390919,5917,41719,70,16187,14846,567700,154317,491115,58778,98839,125164,208334,599355,122662,51098,74945,646796,490761,258496,123899,108366,2015
13121,Fulton County, Georgia,979379,469535,509844,229985,643349,106045,963442,447422,432794,3992,65281,481,13472,15937,734488,244891,663780,53148,123064,153038,334530,860926,118453,50629,97421,880974,666786,367345,153451,145990,2015
13135,Gwinnett County, Georgia,889374,433513,455861,245681,565184,78509,863272,459255,236242,2818,101218,583,63156,26102,798717,90657,562381,72078,133021,157490,199792,655554,233820,106658,62481,826183,597983,303389,149367,145227,2015
15003,Honolulu County, Hawaii,967020,486112,480908,211481,597299,158240,734902,210536,23605,1330,410416,83174,5841,232118,829783,137237,670038,61865,171034,212401,224738,778538,188482,110213,99737,836318,620218,345880,152640,121698,2015
17031,Cook County, Illinois,5152758,2495206,2657552,1161857,3319913,670988,5027867,2902736,1215230,14349,361776,2404,531372,124891,4161691,991067,3536178,482173,838171,914174,1301660,4036242,1116516,538770,522125,4628985,3448022,1738714,847199,862109,2015
17043,DuPage County, Illinois,920900,452131,468769,214838,580929,125133,899645,718449,44786,2915,106357,285,26853,21255,792741,128159,627611,48190,117320,173717,288384,741260,179640,104035,71622,849067,606548,330246,164382,111920,2015
17089,Kane County, Illinois,525939,262540,263399,140482,322212,63245,515181,384883,31031,868,21060,171,77168,10758,468116,57823,338138,57401,75551,98872,106314,428126,97813,39677,43839,481973,339559,179530,93389,66640,2015
17097,Lake County, Illinois,686670,339073,347597,174493,426022,86155,668634,551256,46385,1053,49956,90,19894,18036,608946,77724,448368,43397,95534,109865,199572,559083,127587,58368,60154,624646,448642,240802,119893,87947,2015
17197,Will County, Illinois,677366,334264,343102,177757,420965,78644,659692,502174,75158,796,35622,130,45812,17674,605839,71527,438854,40992,122712,127317,147833,596528,80838,43259,59934,616867,443062,228084,126578,88400,2015
18097,Marion County, Indiana,919974,443795,476179,229032,586364,104578,893794,587016,250062,2784,27072,0,26860,26180,699687,220287,607197,90907,166556,170659,179075,840372,79602,22022,130023,789714,608659,305830,165924,136905,2015
20173,Sedgwick County, Kansas,505240,250510,254730,132999,307141,65100,490070,400961,48442,6093,25131,274,9169,15170,416983,88257,324752,35266,90752,108002,90732,461816,43424,21643,58486,444500,321212,169649,81155,70408,2015
21111,Jefferson County, Kentucky,749470,362418,387052,168762,470840,109868,728451,544627,157068,1715,19279,424,5338,21019,592615,156855,519123,49150,140621,153971,175381,698103,51367,21725,105286,643825,489450,255298,130973,103179,2015
24005,Baltimore County, Maryland,810499,383925,426574,176175,505161,129163,791334,506749,224665,2328,50083,407,7102,19165,673221,137278,569290,50853,149429,151907,217101,708392,102107,50898,98082,711938,526543,296400,121900,108243,2015
24031,Montgomery County, Maryland,1031478,497604,533874,240161,648392,142925,991931,559479,184328,3420,156531,382,87791,39547,882307,149171,709240,71403,94411,130043,413383,689363,342115,178345,82479,945754,674608,385478,172509,116621,2015
24033,Prince George's County, Maryland,888943,427729,461214,200864,582970,105109,865087,145459,563479,3278,37874,261,114736,23856,756896,132047,607684,85217,154252,171629,196586,684244,204699,81491,83626,803056,605173,346340,143491,115342,2015
24510,Baltimore city, Maryland,598106,281203,316903,127810,395638,74658,581208,184300,370099,944,16136,347,9382,16898,442637,155469,417591,62828,124537,103549,126677,549359,48747,18613,94428,503219,407324,193333,89248,124743,2015
25005,Bristol County, Massachusetts,540179,263507,276672,113703,341728,84748,525743,462286,19560,143,11779,305,31670,14436,440126,100053,380805,58707,113509,106791,101798,474835,65344,41337,77702,462361,356483,175142,104069,77272,2015
25009,Essex County, Massachusetts,759764,367301,392463,167454,472827,119483,736109,607138,28013,1999,28677,85,70197,23655,635047,124717,527050,54018,137151,131509,204372,638949,120815,63658,89918,669365,493500,249609,148302,95589,2015
25017,Middlesex County, Massachusetts,1530727,743229,787498,320125,991579,219023,1489962,1203673,76626,1845,169737,494,37587,40765,1244555,286172,1090227,74750,222406,202233,590838,1208423,322304,162971,137578,1391299,1030716,565397,286083,179236,2015
25025,Suffolk County, Massachusetts,734144,356599,377545,132494,518212,83438,691008,401178,170827,1365,62293,47,55298,43136,498121,236023,527666,79420,123508,98434,226304,510007,224137,109281,96492,637168,531163,273436,153726,104001,2015
25027,Worcester County, Massachusetts,789489,385699,403790,174035,501700,113754,770515,671171,36628,1335,37659,165,23557,18974,650527,138962,548277,55929,156369,143742,192237,700879,88610,46256,98927,690341,523647,267465,141873,114309,2015
26081,Kent County, Michigan,626491,308271,318220,155760,393712,77019,602150,500195,60635,2340,17637,149,21194,24341,512620,113871,413147,42233,102165,127332,141417,573995,52496,21168,76863,549273,411033,206547,126623,77863,2015
26099,Macomb County, Michigan,856163,415423,440740,184832,537188,134143,835953,702815,94333,2674,32188,175,3768,20210,713199,142964,599164,63901,181494,210503,143266,761104,95059,59550,122877,732626,561573,282480,149866,129227,2015
26125,Oakland County, Michigan,1231867,599561,632306,268608,774027,189232,1202073,930793,171888,4216,84761,137,10278,29794,1016926,214941,864364,55409,161586,258199,389170,1080472,151395,79922,144205,1087330,807883,410827,231205,165851,2015
26163,Wayne County, Michigan,1738190,834861,903329,415556,1080605,242029,1703649,933096,677306,4534,56633,309,31771,34541,1423230,314960,1160291,166394,351553,378559,263785,1586688,151502,87233,279833,1458042,1127141,465336,290969,370836,2015
27053,Hennepin County, Minnesota,1200292,592210,608082,266474,782472,151346,1160142,881866,154736,6350,85257,95,31838,40150,909126,291166,836890,61693,141843,227782,405572,1026464,173828,84165,120411,1079686,810354,447166,250503,112685,2015
27123,Ramsey County, Minnesota,524247,256490,267757,124024,331660,68563,502138,357531,61124,2301,73456,181,7545,22109,405750,118497,352093,34160,73446,96810,147677,442860,81387,40418,63760,460306,344250,175208,110592,58450,2015
29095,Jackson County, Missouri,675993,326490,349503,162043,422824,91126,656108,451641,160842,2206,11832,1823,27764,19885,527802,148191,456728,49454,130387,138036,138851,636023,39970,15462,94892,580917,440389,242336,101686,96367,2015
29189,St. Louis County, Missouri,983725,465906,517819,219955,602445,161325,960003,677435,232606,1855,41997,467,5643,23722,816728,166997,681097,45569,146924,200824,287780,916168,67557,34702,116001,867724,629310,341241,167716,120353,2015
31055,Douglas County, Nebraska,537780,264762,273018,140200,334766,62814,523539,428003,60468,3987,18277,158,12646,14241,427737,110043,351639,32713,76122,107540,135264,485093,52687,19371,52969,483930,349500,199323,89751,60426,2015
32003,Clark County, Nevada,2088802,1038965,1049837,490059,1311597,287146,1980706,1302601,226034,16343,203388,14146,218194,108096,1719287,369515,1416502,209575,400207,477192,329528,1622526,466276,219395,258425,1824092,1363598,657944,359477,346177,2015
34003,Bergen County, New Jersey,927976,450484,477492,199652,579920,148404,908526,649037,55581,1667,152443,819,48979,19450,813239,114737,655305,50942,156376,135619,312368,642549,285427,179081,75431,852495,604947,328256,142867,133824,2015
34007,Camden County, New Jersey,504199,242301,261898,117070,315031,72098,484621,319006,93475,933,29524,184,41499,19578,430364,73835,343973,37264,101910,93565,111234,446982,57217,34175,67138,436662,328823,166296,88582,73945,2015
34013,Essex County, New Jersey,778516,370374,408142,189336,492295,96885,758405,325265,306272,1736,40392,82,84658,20111,654790,123726,520978,77794,142243,119310,181631,570278,208238,105531,93354,685162,512592,247715,131854,133023,2015
34017,Hudson County, New Jersey,667268,331467,335801,134346,461493,71429,644615,358247,82128,2087,101237,876,100040,22653,532364,134904,476255,75588,128063,84957,187647,383721,283547,131218,64068,603123,474260,258141,106789,109330,2015
34023,Middlesex County, New Jersey,809410,395211,414199,182140,515273,111997,791228,488295,78413,1754,195218,0,27548,18182,716388,93022,567569,66141,145922,116781,238725,534965,274445,149093,74369,734851,536530,280808,127631,128091,2015
34029,Ocean County, New Jersey,581144,280236,300908,136308,317994,126842,570185,530095,18293,173,11705,187,9732,10959,498070,83074,402406,34087,141444,114496,112379,536264,44880,24901,73985,506691,332091,156165,103001,72925,2015
34031,Passaic County, New Jersey,502867,246148,256719,122471,313354,67042,483383,295319,56137,2278,27011,185,102453,19484,446715,56152,332875,60500,120023,69629,82723,364109,138758,84631,42064,460754,326498,161116,66416,98966,2015
34039,Union County, New Jersey,549040,268160,280880,130512,347972,70556,530910,318636,116656,1008,27112,0,67498,18130,484406,64634,370884,53990,112343,79753,124798,380585,168455,84367,49208,499346,363362,188596,94114,80652,2015
35001,Bernalillo County, New Mexico,667896,326923,340973,151265,418949,97682,636011,475427,20779,31016,15920,391,92478,31885,529597,138299,455330,58506,107044,142486,147294,595057,72839,25540,88169,577401,436571,210832,109175,116564,2015
36005,Bronx County, New York,1420412,666755,753657,360259,902282,157871,1368659,284532,461946,9222,52888,63,560008,51753,1207523,212889,906863,257478,249853,216716,182816,910606,509806,251032,195377,1224771,941956,399565,221432,320959,2015
36029,Erie County, New York,896567,432367,464200,186789,559922,149856,878729,702124,120182,4075,30291,285,21772,17838,697579,198988,631203,57442,178818,189509,205434,832621,63946,31779,120990,775237,582808,294479,163017,125312,2015
36047,Kings County, New York,2614180,1238726,1375454,604467,1688944,320769,2547447,1135118,852430,9831,317510,375,232183,66733,2107177,507003,1775475,342771,452079,350636,629989,1627224,986956,578739,263806,2349788,1751874,842110,421866,487898,2015
36055,Monroe County, New York,726222,350597,375625,157599,453855,114768,709009,552494,115231,3564,27047,99,10574,17213,576196,150026,505083,50825,124494,144319,185445,661588,64634,34395,102083,623904,471718,232842,141348,97528,2015
36059,Nassau County, New York,1342931,651602,691329,295555,825586,221790,1302724,923342,157078,2671,125138,116,94379,40207,1216027,126904,932704,80975,226489,216125,409115,1042247,300684,187283,109712,1232678,863316,456808,216359,190149,2015
36061,New York County, New York,1597437,757891,839546,236687,1125874,234876,1525870,895783,234563,5416,195690,682,193736,71567,975101,622336,1238110,165366,143706,173348,755690,1126362,471075,223649,160261,1437012,1147600,636503,273553,237544,2015
36081,Queens County, New York,2313008,1122418,1190590,470375,1528858,313775,2233611,906138,417151,9684,588820,419,311399,79397,1979152,333856,1645771,314622,455574,365776,509799,1199808,1113200,631303,207304,2105232,1578388,813315,362048,403025,2015
36103,Suffolk County, New York,1469635,722494,747141,321278,921516,226841,1432445,1194760,110911,2489,57657,276,66352,37190,1296883,172752,1018990,100972,286471,277154,354393,1240315,229320,125975,149835,1319095,963669,501120,243321,219228,2015
36119,Westchester County, New York,953727,461714,492013,218103,586856,148768,925777,635653,136003,2678,57959,256,93228,27950,822551,131176,657457,83543,128930,132772,312212,704132,249595,129967,87167,866426,612591,315251,159591,137749,2015
37081,Guilford County, North Carolina,502547,239441,263106,116244,314825,71478,487729,282887,165194,1625,23784,314,13925,14818,409060,93487,342189,40325,77717,105962,118185,453155,49392,18456,56881,445502,329094,169001,78298,81795,2015
37119,Mecklenburg County, North Carolina,1019570,488605,530965,250008,665509,104053,993569,579447,315217,3447,56218,119,39121,26001,805302,214268,681417,71620,129075,184658,296064,869991,149579,53386,90204,928789,690334,375710,178150,136474,2015
37183,Wake County, North Carolina,1002347,488736,513611,251439,647967,102941,975404,667702,208343,3207,64807,348,30997,26943,835545,166802,667773,49542,109007,171882,337342,864468,137879,58756,87696,914269,675803,381174,165907,128722,2015
39035,Cuyahoga County, Ohio,1229345,584177,645168,264725,761984,202636,1198039,778201,363937,3901,35501,522,15977,31306,956126,273219,859362,95047,243670,255956,264689,1139437,89908,53568,186314,1042823,792766,380170,221985,190611,2015
39049,Franklin County, Ohio,1223451,596609,626842,292485,796263,134703,1178722,832630,268183,2049,56034,306,19520,44729,935046,288405,824773,77408,204875,223567,318923,1094159,129292,54097,140925,1082094,826442,445797,225018,155627,2015
39061,Hamilton County, Ohio,790581,380919,409662,185147,493846,111588,768582,539902,202410,925,18722,287,6336,21999,609496,181085,536010,44886,144902,148760,197462,749759,40822,20016,97691,692683,514422,261546,146976,105900,2015
39113,Montgomery County, Ohio,514753,247909,266844,117178,310378,87197,496594,376525,104647,1368,10015,141,3898,18159,406417,108336,357765,33982,100727,123682,99374,490270,24483,13055,79741,433653,324064,160055,84677,79332,2015
39153,Summit County, Ohio,533712,259900,273812,115355,331153,87204,518383,425109,75572,718,15795,200,989,15329,428472,105240,373774,31198,119793,105702,117081,506911,26801,12293,67385,466284,345734,178430,90025,77279,2015
40109,Oklahoma County, Oklahoma,761632,371148,390484,197879,468429,95324,710941,529292,110854,20200,25606,665,24324,50691,614138,147494,496434,68326,129308,144155,154645,676069,85563,26246,99517,659209,486260,255712,121358,109190,2015
40143,Tulsa County, Oklahoma,629119,306117,323002,159664,387419,82036,577495,438921,63574,29628,18582,58,26732,51624,514707,114412,413585,44213,105189,137829,126354,574433,54686,15990,86495,542389,405022,222429,97575,85018,2015
41051,Multnomah County, Oregon,775522,383344,392178,151047,530437,94038,734799,612401,42255,5603,54756,4464,15320,40723,555087,220435,565143,54791,95856,164797,249699,668117,107405,49494,103221,672131,545384,266272,174502,104610,2015
41067,Washington County, Oregon,568357,280752,287605,135616,363206,69535,541615,443331,10456,4487,56560,2142,24639,26742,471063,97294,387215,35096,65021,121384,165714,469357,99000,43349,59311,509006,379106,189945,112259,76902,2015
42003,Allegheny County, Pennsylvania,1197057,577163,619894,230494,756801,209762,1165052,966488,151640,1007,41351,393,4173,32005,911598,285459,872473,54276,247929,220584,349684,1125349,71708,32604,159274,1037406,783263,422861,207416,152986,2015
42045,Delaware County, Pennsylvania,542837,259295,283542,123318,335837,83682,527270,377864,113435,886,27949,0,7136,15567,459788,83049,374430,25814,119457,90347,138812,489161,53676,31949,69122,473715,351192,183886,94668,72638,2015
42071,Lancaster County, Pennsylvania,523153,255284,267869,125972,310494,86687,511554,462613,22259,920,10900,45,14817,11599,447497,75656,352630,54139,128039,78964,91488,499162,23991,11459,61427,461565,325784,174676,88053,63055,2015
42091,Montgomery County, Pennsylvania,797361,386649,410712,176242,490461,130658,779268,633990,68047,794,61967,235,14235,18093,676847,120514,561922,32840,137875,119814,271393,712521,84840,46451,80484,716727,511427,285982,135733,89712,2015
42101,Philadelphia County, Pennsylvania,1525590,721036,804554,341582,992258,191750,1483981,634634,651226,5493,109402,1403,81823,41609,1164423,361167,1038492,174551,340755,236549,286637,1323712,201878,102757,257472,1268017,1027008,456423,248855,321730,2015
44007,Providence County, Rhode Island,608265,294506,313759,131197,390566,86502,583436,441066,54881,3322,24640,211,59316,24829,486809,121456,421410,65360,128184,109462,118404,492695,115570,60641,83876,523923,405858,197547,107308,101003,2015
47037,Davidson County, Tennessee,659367,316888,342479,143441,442165,73761,640847,420366,178503,2724,20299,76,18879,18520,496575,162792,458421,52429,109456,118622,177914,570425,88942,27665,81584,577156,454061,252854,116538,84669,2015
47157,Shelby County, Tennessee,919280,434446,484834,234996,574703,109581,901945,365875,486046,593,24069,621,24741,17335,764129,155151,597242,75238,167363,173618,181023,858138,61142,18379,108834,809031,601680,299597,148401,153682,2015
48029,Bexar County, Texas,1866463,915059,951404,487658,1164883,213922,1812259,1516035,141804,14179,52849,1799,85593,54204,1595196,271267,1189556,197467,309158,366458,316473,1621299,245164,95517,256098,1598454,1218876,623358,282746,312772,2015
48085,Collin County, Texas,909894,446745,463149,244230,575063,90601,885456,647624,85491,6308,125464,641,19928,24438,809048,100846,592581,40362,92590,161470,298159,725730,184164,81794,64076,844816,604860,358898,122723,123239,2015
48113,Dallas County, Texas,2520978,1237107,1283871,673488,1600907,246583,2458403,1571658,559331,10212,150813,1328,165061,62575,2116042,404936,1605190,357753,356783,404294,486360,1899010,621968,184132,242954,2277200,1667147,911488,368151,387508,2015
48121,Denton County, Texas,767683,377747,389936,199323,498783,69577,744258,578772,73003,2601,61888,0,27994,23425,658413,109270,502308,39306,95660,155402,211940,654899,112784,52287,60804,706666,521399,301814,129636,89949,2015
48141,El Paso County, Texas,821447,398753,422694,232641,493085,95721,806898,696691,29421,5546,10073,75,65092,14549,742886,78561,497486,112086,124687,146589,114124,618644,202803,89973,119232,688540,518321,242531,121805,153985,2015
48201,Harris County, Texas,4495844,2232890,2262954,1214931,2859380,421533,4394119,2875752,844473,16733,311352,1094,344715,101725,3877982,617862,2854543,569600,672761,756987,855195,3299938,1195906,403662,407668,4086636,2990209,1595859,676894,717456,2015
48215,Hidalgo County, Texas,831453,402451,429002,279833,463943,87677,822259,737621,4836,1581,9113,200,68908,9194,782635,48818,460685,175096,102455,102611,80523,600882,230571,61709,106728,724063,494642,202453,124500,167689,2015
48339,Montgomery County, Texas,534000,263427,270573,142470,326676,64854,512845,453557,22716,2050,14434,0,20088,21155,474962,59038,345579,47464,80640,99716,117759,466623,67377,24230,51639,481849,342297,172606,80895,88796,2015
48439,Tarrant County, Texas,1955259,954234,1001025,526523,1226501,202235,1898014,1361767,310961,8036,102368,3693,111189,57245,1691418,263841,1249137,181873,297507,382216,387541,1642014,313245,122141,208152,1745780,1285948,699410,305177,281361,2015
48453,Travis County, Texas,1152969,580402,572567,265881,786345,100743,1117724,853922,96949,4785,74552,354,87162,35245,863940,289029,788687,90839,136638,187300,373910,943626,209343,70387,93907,1058949,811302,469089,194906,147307,2015
49035,Salt Lake County, Utah,1093499,547050,546449,306317,679404,107778,1061719,889749,19738,8406,43214,15196,85416,31780,938303,155196,681846,67105,166902,221157,226682,960680,132819,52169,104181,988872,710736,382508,198257,129971,2015
49049,Utah County, Utah,558651,282355,276296,196565,320623,41463,541379,513685,3942,2489,8993,3448,8822,17272,506204,52447,276971,19279,46898,104443,106351,517474,41177,14358,43977,514403,341138,143323,128849,68966,2015
51059,Fairfax County, Virginia,1133539,560640,572899,270630,727982,134927,1080550,696087,107583,1802,215776,277,59025,52989,971955,161584,772463,61484,107160,144372,459447,774886,358653,194289,83298,1039323,756857,432603,195258,128996,2015
53033,King County, Washington,2087974,1043489,1044485,432851,1396622,258501,1966352,1379442,132258,13658,342584,17896,80514,121622,1601238,486736,1488344,105469,236310,398113,748452,1632649,455325,217419,195503,1891146,1444451,772342,395460,276649,2015
53053,Pierce County, Washington,828673,411503,417170,198204,523309,107160,765348,607112,56059,9493,52507,12098,28079,63325,686747,141926,555442,46258,159062,206786,143336,746305,82368,45265,111860,706372,544434,266981,136153,141300,2015
53061,Snohomish County, Washington,760160,380086,380074,171871,494396,93893,713950,589442,19233,5882,73592,4248,21553,46210,630900,129260,522177,43212,124583,184941,169441,639650,120510,59599,93730,663865,515606,270872,136285,108449,2015
55025,Dane County, Wisconsin,509092,251728,257364,108281,339189,61622,494267,428581,26457,1322,28165,211,9531,14825,372575,136517,338028,16299,62203,94469,165057,465134,43958,16355,43821,465165,350623,194517,113293,42813,2015
55079,Milwaukee County, Wisconsin,934793,450698,484095,229688,590084,115021,904423,567710,246117,5321,39823,325,45127,30370,713641,221152,620984,80351,165948,189304,185381,848877,85916,33755,126819,807636,613525,308587,162659,142279,2015
1073,Jefferson County, Alabama,646109,303814,342295,150954,398144,97011,632062,333373,274448,1763,8188,323,13967,14047,529432,116677,443119,45995,115411,134400,147313,618765,27344,8816,100836,544884,415856,209672,101728,104456,2016
4013,Maricopa County, Arizona,4186451,2067165,2119286,1021756,2550778,613917,4037753,3187742,225220,80292,167569,9808,367122,148698,3482024,704427,2783199,354031,623635,912428,893105,3550795,635656,259010,475822,3705882,2665413,1387791,642779,634843,2016
4019,Pima County, Arizona,987885,480085,507800,214237,582116,191532,940968,757369,31315,31126,28289,1550,91319,46917,786945,200940,663793,78153,145819,225934,213887,854005,133880,59909,154288,830059,606147,276344,175439,154364,2016
6001,Alameda County, California,1621485,797490,823995,341848,1068306,211331,1517475,676666,171277,9940,476962,13798,168832,104010,1339363,282122,1151144,140107,200901,286065,524071,1085478,536007,282913,155660,1464624,1102755,578464,281482,242809,2016
6013,Contra Costa County, California,1125444,550934,574510,257759,700532,167153,1044129,653438,96035,3159,183061,4891,103545,81315,981935,143509,775357,82353,132697,237663,322644,841836,283608,149431,131047,993425,730839,361462,202296,167081,2016
6019,Fresno County, California,966379,480255,486124,278306,574037,114036,932259,632450,46317,9927,101387,1129,141049,34120,848687,117692,590970,149402,136201,185145,120222,756542,209837,82038,118462,846772,603389,242751,173573,187065,2016
6029,Kern County, California,852204,425164,427040,253851,508793,89560,823150,622965,41159,11561,39834,2985,104646,29054,759071,93133,507773,129226,136121,156221,86205,679332,172872,61236,93851,757187,534005,237571,126175,170259,2016
6037,Los Angeles County, California,9989112,4915867,5073245,2221938,6485670,1281504,9604491,5014444,805758,64132,1450800,25313,2244044,384621,8419699,1569413,6822800,1470854,1415796,1774227,2161923,6506117,3482995,1794113,1023001,8962491,6749117,3271442,1708124,1769551,2016
6059,Orange County, California,3136217,1549981,1586236,703108,1996094,437015,3019559,1963603,52031,13214,632191,10579,347941,116658,2701342,434875,2146513,323632,365963,596643,860275,2177162,959055,517206,267354,2867744,2084652,1034119,565522,485011,2016
6065,Riverside County, California,2353864,1166276,1187588,606089,1419395,328380,2248453,1389396,148357,20270,145851,7145,537434,105411,2089274,264590,1519593,285344,398359,501758,334132,1837760,516104,242296,283945,2066079,1490654,648550,396560,445544,2016
6067,Sacramento County, California,1494002,725350,768652,357461,933414,203127,1387410,872537,144219,10037,229839,16021,114757,106592,1242284,251718,1006383,135249,226855,342356,301923,1181550,312452,179698,182292,1310902,974376,458645,259152,256579,2016
6071,San Bernardino County, California,2081216,1019135,1062081,564457,1285240,231519,1982450,1286484,173200,14673,149284,6269,352540,98766,1883741,197475,1298363,269572,341428,422450,264913,1639680,441536,220594,240881,1835576,1351580,594734,336036,420810,2016
6073,San Diego County, California,3233771,1606945,1626826,717500,2077943,438328,3067093,2324448,155560,24652,385103,13675,163655,166678,2679538,554233,2205839,298967,401848,674311,830713,2442285,791486,408885,325214,2875895,2156351,1063793,576456,516102,2016
6075,San Francisco County, California,857255,437414,419841,116119,614335,126801,811130,398229,42348,3048,296812,1967,68726,46125,565336,291919,685491,82499,83755,126039,393198,554381,302874,190230,94442,762611,624063,355950,163486,104627,2016
6077,San Joaquin County, California,720252,357557,362695,197598,434233,88421,653342,409963,50279,5416,108884,4697,74103,66910,639211,81041,454849,103041,124596,150436,76776,555398,164854,76154,95225,624537,457178,194075,129169,133934,2016
6081,San Mateo County, California,758012,373916,384096,158779,485137,114096,713868,385874,16915,2821,213694,10712,83852,44144,648723,109289,544192,58363,83373,127213,275243,496119,261893,146765,65426,692486,501592,272804,140631,88157,2016
6085,Santa Clara County, California,1889316,952509,936807,429493,1218935,240888,1792593,829669,44790,8538,676496,8405,224695,96723,1618359,270957,1312448,166710,195900,278650,671188,1143247,746069,392152,148795,1740174,1265703,664449,326949,274305,2016
6099,Stanislaus County, California,536626,263109,273517,145002,323815,67809,514001,391801,16935,3427,30281,3066,68491,22625,482066,54560,340009,80416,93474,110499,55620,423400,113226,50001,70468,466055,339708,143166,99613,96929,2016
6111,Ventura County, California,837424,413834,423590,196558,518679,122187,798447,672839,13870,5546,60415,1787,43990,38977,728869,108555,564664,89697,104493,180488,189986,647540,189884,89491,95994,739605,542926,263200,157873,121853,2016
8005,Arapahoe County, Colorado,630769,311692,319077,151276,401937,77556,607182,447185,68535,3620,38524,1592,47726,23587,523440,107329,425798,30489,92981,124708,177620,537755,93014,37130,56324,572769,418863,242149,106695,70019,2016
8031,Denver County, Colorado,682515,342479,340036,139435,467413,75667,659206,513791,66916,5305,25618,410,47166,23309,478772,203743,489952,62436,87741,106079,233696,579940,102575,39163,65790,616494,480237,268844,127535,83858,2016
8041,El Paso County, Colorado,667991,333673,334318,166506,419232,82253,627298,536884,41042,3540,17788,2731,25313,40693,559758,108233,437986,24374,86070,156867,170675,620246,47745,25052,79044,570760,436484,228640,119589,88255,2016
9001,Fairfield County, Connecticut,925845,450766,475079,215037,575731,135077,896063,684918,106860,2783,49848,502,51152,29782,793783,132062,631445,61799,137260,135637,296749,722214,203631,96618,89898,835727,601731,301938,181819,117974,2016
9003,Hartford County, Connecticut,870087,420217,449870,188265,542186,139636,840938,623590,115260,2632,45120,29,54307,29149,709189,160898,607943,62800,167941,147786,229416,742311,127776,73559,105634,764135,565879,304715,144081,117083,2016
9009,New Haven County, Connecticut,830201,400383,429818,174427,521648,134126,803725,616725,107106,1747,34435,423,43289,26476,668243,161958,584067,59076,176993,140853,207145,724515,105686,57632,97034,732607,544396,280128,146905,117363,2016
10003,New Castle County, Delaware,540302,260077,280225,120248,341494,78560,527399,350782,133761,1877,29686,950,10343,12903,446218,94084,375232,30228,117600,92402,135002,477380,62922,32673,59937,479808,355911,193053,80208,82650,2016
11001,District of Columbia, District of Columbia,647654,306361,341293,118383,452477,76794,630845,260919,307253,1966,24027,41,36639,16809,415933,231721,474099,43455,83617,75263,271764,559896,87758,39479,74425,571180,461815,268513,100994,92308,2016
12009,Brevard County, Florida,573235,278657,294578,106003,334954,132278,556398,473866,56623,1214,13827,170,10698,16837,468443,104792,426463,34385,120279,146439,125360,519381,53854,33468,88656,483718,349445,154622,91552,103271,2016
12011,Broward County, Florida,1893618,919295,974323,402818,1187919,302881,1833623,1155186,539194,5772,68889,1623,62959,59995,1566956,326662,1339181,161509,357757,406791,413124,1251828,641790,385998,208751,1683842,1237486,649534,313822,274130,2016
12031,Duval County, Florida,904630,436199,468431,206543,575953,122134,868998,544361,266370,2013,39801,429,16024,35632,722727,181903,622953,69055,168552,201138,184208,813045,91585,51424,118763,778099,597736,317448,137986,142302,2016
12057,Hillsborough County, Florida,1354249,659086,695163,310101,858357,185791,1309260,956733,224059,4763,54253,1279,68173,44989,1089049,265200,929058,110820,258496,258602,301140,1119682,234567,108994,162204,1189198,892906,471616,216220,205070,2016
12071,Lee County, Florida,713021,349319,363702,129837,387660,195524,699789,607395,59022,1457,11121,129,20665,13232,587194,125827,536184,67080,162355,154288,152461,600683,112338,53864,97659,615273,401520,200228,97691,103601,2016
12086,Miami-Dade County, Florida,2672145,1289790,1382355,546556,1701422,424167,2630433,1995034,463343,4491,42681,1265,123619,41712,2305980,366165,1904068,354084,536140,478410,535434,1225078,1447067,821324,274821,2396203,1763056,917773,371548,473735,2016
12095,Orange County, Florida,1281519,628129,653390,292464,844906,144149,1235798,826258,270656,1547,69598,50,67689,45721,1043111,238408,865896,112011,209684,250470,293731,987275,294244,148201,142175,1138593,876687,452942,217717,206028,2016
12099,Palm Beach County, Florida,1424039,686684,737355,276269,816423,331347,1394937,1066558,261212,1811,38180,536,26640,29102,1148666,275373,1042649,129914,255688,289982,367065,1071781,352258,192908,176378,1247402,849613,435885,222185,191543,2016
12101,Pasco County, Florida,504332,245519,258813,101509,287967,114856,492894,445096,27475,1337,12829,190,5967,11438,422819,81513,368323,40704,126294,115913,85412,459743,44589,25881,86786,416617,301071,143458,66208,91405,2016
12103,Pinellas County, Florida,946232,453684,492548,157053,566218,222961,920436,773746,95139,3098,32517,796,15140,25796,714009,232223,726075,67702,202321,241469,214583,837101,109131,68303,152750,792638,586169,301197,139003,145969,2016
12105,Polk County, Florida,652803,317742,335061,147063,374202,131538,637647,515425,98177,1818,12505,306,9416,15156,550092,102711,454356,69661,161916,130242,92537,581505,71298,31576,103606,548476,390357,188031,86593,115733,2016
12127,Volusia County, Florida,519158,253570,265588,91329,303696,124133,506767,434463,52800,2528,9653,64,7259,12391,409325,109833,387935,39352,120650,133820,94113,479273,39885,23901,94612,424383,315284,145465,75505,94314,2016
13067,Cobb County, Georgia,737148,355214,381934,179623,473422,84103,711301,433275,198278,3131,39514,676,36427,25847,614290,122858,495167,43820,89778,130011,231558,617430,119718,50284,65712,670767,494207,279162,121056,93989,2016
13089,DeKalb County, Georgia,725695,344136,381559,171855,473339,80501,709037,252729,397084,5253,44394,101,9476,16658,570293,155402,495044,53352,101813,123529,216350,606917,118778,48680,76945,647860,490800,265808,118072,106920,2016
13121,Fulton County, Georgia,991572,476986,514586,229639,651267,110666,962774,446542,431219,8781,63861,879,11492,28798,740793,250779,678712,52943,122948,151902,350919,860324,131248,50667,107026,883961,679546,368418,163126,148002,2016
13135,Gwinnett County, Georgia,900628,439063,461565,246837,569858,83933,874209,434591,246382,1198,103886,82,88070,26419,808181,92447,571706,69955,131005,171628,199118,675023,225605,100992,62067,837909,597940,327030,139198,131712,2016
15003,Honolulu County, Hawaii,960055,479972,480083,207279,591858,160918,728953,195938,20355,1596,412797,91222,7045,231102,827450,132605,673291,56659,171643,211542,233447,770309,189746,111261,103867,830973,613704,349863,142228,121613,2016
17031,Cook County, Illinois,5115390,2479873,2635517,1148231,3284041,683118,4981883,2872250,1196400,14268,364443,1721,532801,133507,4115985,999405,3520974,466510,816219,900460,1337785,4029387,1086003,538296,516755,4597794,3412535,1763498,851616,797421,2016
17043,DuPage County, Illinois,916826,450320,466506,212759,574875,129192,891750,704041,44905,1054,106220,481,35049,25076,787150,129676,627112,46097,114656,159660,306699,747074,169752,98620,78663,837884,600796,335716,154888,110192,2016
17089,Kane County, Illinois,525815,262205,263610,137674,322663,65478,513660,370439,29213,2095,21230,33,90650,12155,465807,60008,341643,51655,75047,99455,115486,430697,95118,41915,45439,480149,338925,174944,98059,65922,2016
17097,Lake County, Illinois,686476,339483,346993,173188,423958,89330,668522,519451,44288,1206,51478,310,51789,17954,602239,84237,448531,43412,90919,113950,200250,556491,129985,62868,63513,620922,445825,240890,120024,84911,2016
18097,Marion County, Indiana,923062,444757,478305,229911,586335,106816,890613,566935,254120,2870,27821,199,38668,32449,709525,213537,609822,77110,171481,175633,185598,834025,89037,25898,124246,798361,609169,320643,150612,137914,2016
20173,Sedgwick County, Kansas,506343,249158,257185,132776,306220,67347,482052,396214,41655,4549,20869,0,18765,24291,412327,94016,326961,35400,83799,104178,103584,464294,42049,17683,58962,446419,321158,172910,84598,63650,2016
21111,Jefferson County, Kentucky,749670,362973,386697,168338,468080,113252,729735,540190,161418,1477,21038,409,5203,19935,586622,163048,520905,50759,135370,166676,168100,698452,51218,21643,110294,639090,487371,261407,124642,101322,2016
24005,Baltimore County, Maryland,810257,384920,425337,175788,501415,133054,789702,499305,232591,2422,48819,579,5986,20555,668279,141978,570376,47064,152547,151475,219290,708452,101805,53346,94921,714796,519253,296828,118296,104129,2016
24031,Montgomery County, Maryland,1036302,499722,536580,243269,644682,148351,993088,571118,188618,1940,154006,239,77167,43214,892098,144204,710519,56947,100658,130755,422159,692918,343384,184976,79746,953831,670623,381244,176234,113145,2016
24033,Prince George's County, Maryland,889371,427504,461867,201019,578448,109904,861330,151128,564643,3761,36544,287,104967,28041,744674,144697,607875,84829,157277,170867,194902,689231,200140,81549,86655,800303,600160,348326,144177,107657,2016
24510,Baltimore city, Maryland,593353,277506,315847,126862,390265,76226,580357,182410,372739,1787,14347,544,8530,12996,428240,165113,415933,61413,122260,102626,129634,544785,48568,19653,90029,502336,402783,199647,96086,107050,2016
25005,Bristol County, Massachusetts,543781,265062,278719,114655,341753,87373,530917,458058,21639,105,13105,231,37779,12864,453043,90738,383933,53714,110030,106772,113417,474567,69214,43844,81247,462310,355274,183393,101652,70229,2016
25009,Essex County, Massachusetts,762523,368249,394274,166144,473166,123213,743327,622429,29326,1362,26580,366,63264,19196,637697,124826,530468,57736,131347,136304,205081,633033,129490,73893,97458,664656,493375,258163,144525,90687,2016
25017,Middlesex County, Massachusetts,1533815,749661,784154,316944,992788,224083,1496673,1182026,82111,2238,179596,517,50185,37142,1246071,287744,1094705,73582,209400,203513,608210,1206807,327008,162256,145676,1386625,1031202,581332,285326,164544,2016
25025,Suffolk County, Massachusetts,739133,358761,380372,132051,521421,85661,681997,401700,174370,2656,62319,252,40700,57136,502841,236292,534512,77603,121267,95622,240020,507160,231973,105077,88759,649534,536081,281441,152453,102187,2016
25027,Worcester County, Massachusetts,790732,388215,402517,173104,501015,116613,770653,660444,36482,1485,38766,292,33184,20079,645592,145140,550156,52802,151879,145835,199640,699149,91583,50018,96386,693770,522581,277149,143473,101959,2016
26081,Kent County, Michigan,630913,310840,320073,155463,395791,79659,605805,506035,58459,1930,18556,67,20758,25108,520008,110905,417985,41136,102030,128665,146154,578929,51984,20055,76564,554014,412733,216767,119891,76075,2016
26099,Macomb County, Michigan,859990,418805,441185,185004,537414,137572,839336,701220,98848,1737,32772,0,4759,20654,721633,138357,603387,57765,187787,207203,150632,765902,94088,59037,120585,738699,561222,283103,150110,128009,2016
26125,Oakland County, Michigan,1233237,601704,631533,265388,773365,194484,1193478,926458,165593,2965,87197,232,11033,39759,999782,233455,869284,51767,159711,254510,403296,1078372,154865,81565,145400,1087450,807430,428412,217046,161972,2016
26163,Wayne County, Michigan,1727249,829757,897492,412191,1068781,246277,1680113,914384,670262,5406,53487,420,36154,47136,1407317,319932,1159869,163208,346919,381726,268016,1571899,155350,87129,280232,1446564,1115786,482456,294846,338484,2016
27053,Hennepin County, Minnesota,1210680,597235,613445,268119,785119,157442,1168477,880870,154065,9101,83637,483,40321,42203,909355,301325,844442,58246,138709,234087,413400,1039127,171553,83224,122749,1087746,813300,458959,233482,120859,2016
27123,Ramsey County, Minnesota,526683,257147,269536,124456,331276,70951,500850,348923,58205,2959,75125,209,15429,25833,410619,116064,354963,34123,78802,96260,145778,441492,85191,45434,61701,464714,345074,180067,105601,59406,2016
29095,Jackson County, Missouri,680346,329546,350800,162449,424185,93712,658088,456003,158486,2993,12337,2433,25836,22258,531382,148964,462030,40995,136151,140125,144759,641629,38717,16474,91261,588637,441725,246794,104074,90857,2016
29189,St. Louis County, Missouri,978259,465382,512877,217531,596185,164543,953587,669939,234084,1834,38674,188,8868,24672,802955,175304,679929,45786,141215,194876,298052,904437,73822,41018,118159,859612,622951,337967,167704,117280,2016
31055,Douglas County, Nebraska,542214,267466,274748,140736,336292,65186,525990,434898,59207,1427,19064,371,11023,16224,439023,103191,355104,36070,77301,104316,137417,490633,51581,14834,58352,482674,351003,202792,88204,60007,2016
32003,Clark County, Nevada,2126703,1056266,1070437,496834,1328813,301056,2017119,1315479,239589,12831,211452,17631,220137,109584,1753768,372935,1449829,209146,428601,472222,339860,1636393,490310,235516,262114,1859504,1385337,685660,353484,346193,2016
34003,Bergen County, New Jersey,928064,450083,477981,198927,578729,150408,900436,670814,54483,1648,152506,804,20181,27628,814979,113085,655193,50755,145851,134670,323917,638473,289591,180847,70727,856948,604396,330800,142579,131017,2016
34007,Camden County, New Jersey,503489,243955,259534,116442,313435,73612,489322,320657,94245,1032,29453,0,43935,14167,434187,69302,344718,37882,103594,93753,109489,445587,57902,33215,63702,439629,327377,168685,87119,71573,2016
34013,Essex County, New Jersey,776820,369302,407518,186501,491295,99024,755448,347494,306802,1518,41383,0,58251,21372,647099,129721,523165,72844,143166,125546,181609,581061,195759,108185,87137,689536,511223,248198,127121,135904,2016
34017,Hudson County, New Jersey,669511,332078,337433,137029,460129,72353,643229,362786,79336,2484,102248,731,95644,26282,533561,135950,477964,72900,126026,83057,195981,371444,298067,138456,63309,605931,473721,260318,107277,106126,2016
34023,Middlesex County, New Jersey,807146,393933,413213,181108,510296,115742,785763,474822,78013,2096,194746,297,35789,21383,713091,94055,566720,57062,146013,121736,241909,533114,274032,147834,77518,729514,530258,284285,126401,119572,2016
34029,Ocean County, New Jersey,585713,282247,303466,138929,318136,128648,577350,531460,16665,400,11353,664,16808,8363,492475,93238,403600,36279,134650,115937,116734,536152,49561,29167,83395,501697,333654,156788,97884,78982,2016
34031,Passaic County, New Jersey,499804,243641,256163,121909,310707,67188,486147,327394,55897,1643,26455,96,74662,13657,440810,58994,331160,60290,109204,68909,92757,344301,155503,81059,44714,454644,324051,172017,71031,81003,2016
34039,Union County, New Jersey,549148,267631,281517,130248,346199,72701,533274,300967,113430,2210,27485,0,89182,15874,482440,66708,371857,51335,105304,84090,131128,379013,170135,86105,54289,494588,360941,196123,85661,79157,2016
35001,Bernalillo County, New Mexico,669062,327327,341735,150058,417612,101392,645620,475476,17736,33876,18354,498,99680,23442,535484,133578,459643,50565,107826,145993,155259,602379,66683,30010,85987,580833,435531,218681,109741,107109,2016
36005,Bronx County, New York,1421501,666340,755161,359351,900687,161463,1365222,300396,482819,8744,51194,340,521729,56279,1213523,207978,913591,252352,260737,230781,169721,881414,540087,265812,210185,1211167,936989,409119,228657,299213,2016
36029,Erie County, New York,895844,432452,463392,186725,556322,152797,875155,705684,114556,4725,32285,377,17528,20689,696530,199314,633562,52865,178226,190519,211952,835845,59999,32195,118532,776747,578799,293883,157852,127064,2016
36047,Kings County, New York,2603170,1233590,1369580,599924,1676452,326794,2524479,1114287,851228,8670,313656,1322,235316,78691,2078749,524421,1779809,332993,445862,351611,649343,1650028,953142,568996,274447,2328270,1739949,837456,433215,469278,2016
36055,Monroe County, New York,723337,349682,373655,155988,449692,117657,702481,552588,110266,2632,24672,309,12014,20856,568273,155064,505534,49520,113541,152237,190236,659598,63739,38449,102297,620962,468336,234485,134413,99438,2016
36059,Nassau County, New York,1341195,651004,690191,291875,823572,225748,1300266,915403,154490,3420,126721,285,99947,40929,1213714,127481,934017,78717,213221,219569,422510,1038745,302450,193492,112315,1228438,860720,461330,212790,186600,2016
36061,New York County, New York,1596749,759647,837102,238032,1118940,239777,1521113,902049,237848,4513,197096,872,178735,75636,996955,599794,1237840,156898,154449,174256,752237,1116097,480652,231620,166835,1429764,1141971,640761,260797,240413,2016
36081,Queens County, New York,2306296,1118035,1188261,468423,1515877,321996,2223575,894078,412249,9453,589916,1209,316670,82721,1952610,353686,1647219,302085,457357,367011,520766,1213743,1092553,607021,228374,2076750,1565620,816946,356035,392639,2016
36103,Suffolk County, New York,1464253,719859,744394,315876,915717,232660,1437050,1180051,106899,3351,54516,833,91400,27203,1302368,161885,1019794,92284,293108,276571,357831,1232371,231882,128395,139084,1324640,956652,511892,230410,214350,2016
36119,Westchester County, New York,951318,460173,491145,215540,583297,152481,919597,614268,138290,2642,57433,103,106861,31721,813214,138104,656604,82670,124723,132762,316449,704123,247195,130603,89123,862195,610175,312141,167208,130826,2016
37081,Guilford County, North Carolina,504936,239865,265071,117212,314255,73469,493853,284431,166385,1947,25969,383,14738,11083,405202,99734,343936,41433,84381,98696,119426,451214,53722,23033,59339,445470,327525,162774,84207,80544,2016
37119,Mecklenburg County, North Carolina,1039837,499273,540564,252706,678015,109116,1013700,566328,329096,2740,58997,786,55753,26137,837442,202395,699843,64880,120143,202223,312597,880351,159486,61986,82131,957126,705510,402135,161988,141387,2016
37183,Wake County, North Carolina,1023722,497493,526229,253638,661065,109019,993616,673197,208240,3601,68501,157,39920,30106,843012,180710,686125,47079,95886,175414,367746,881704,142018,65580,90361,932029,688569,396955,172911,118703,2016
39035,Cuyahoga County, Ohio,1223032,582159,640873,261367,756246,205419,1181734,765467,358902,2275,33773,389,20928,41298,942671,280361,858033,83927,247575,256172,270359,1133391,89641,56212,185219,1037612,788752,393490,211157,184105,2016
39049,Franklin County, Ohio,1232457,601374,631083,291313,801353,139791,1186137,832440,274454,1698,61558,747,15240,46320,945456,287001,834771,75270,212022,219173,328306,1104749,127708,59905,146591,1085273,831109,458141,222901,150067,2016
39061,Hamilton County, Ohio,791246,382264,408982,184403,492956,113887,768881,529991,204965,797,21101,85,11942,22365,610604,180642,538336,46884,142668,148834,199950,749142,42104,19640,102427,688621,513283,267561,145829,99893,2016
39113,Montgomery County, Ohio,515687,248402,267285,117032,310339,88316,499422,375339,108811,629,11303,374,2966,16265,405546,110141,358259,36072,98825,130639,92723,490103,25584,15345,79972,433560,323658,163299,85744,74615,2016
39153,Summit County, Ohio,530101,257470,272631,112334,328175,89592,514480,419265,76268,503,16910,149,1385,15621,424917,105184,373883,30470,117528,107456,118429,502000,28101,11849,73171,456860,343163,176568,92384,74211,2016
40109,Oklahoma County, Oklahoma,766221,372934,393287,199527,467630,99064,717223,528239,116225,23997,23979,1011,23772,48998,615135,151086,502087,65229,126422,151759,158677,687436,78785,24967,106259,657598,488055,259786,120560,107709,2016
40143,Tulsa County, Oklahoma,633092,308921,324171,160690,387886,84516,581069,438893,62392,32242,20996,279,26267,52023,516935,116157,417575,44761,107431,134213,131170,577683,55409,17776,88503,544326,404750,214725,103664,86361,2016
41051,Multnomah County, Oregon,785692,389796,395896,151837,534796,99059,745240,619421,44376,5561,55565,4483,15834,40452,565460,220232,574273,50255,93809,169082,261127,677306,108386,50466,102426,682731,550683,280662,169964,100057,2016
41067,Washington County, Oregon,578160,284957,293203,136568,368852,72740,542553,435468,10677,2224,58547,2262,33375,35607,478667,99493,394912,33425,69730,120866,170891,478923,99237,45647,59873,518159,384179,202402,112208,69569,2016
42003,Allegheny County, Pennsylvania,1192434,576207,616227,229101,749552,213781,1155085,959797,148274,975,40799,411,4829,37349,902126,290308,871268,47180,234546,223251,366291,1125284,67150,30421,165103,1026399,775323,427132,207318,140873,2016
42045,Delaware County, Pennsylvania,542743,259603,283140,123185,334162,85396,530020,375788,115344,1071,32181,0,5636,12723,457423,85320,374924,25750,115190,88489,145495,485379,57364,32770,63873,478801,349814,180127,94571,75116,2016
42071,Lancaster County, Pennsylvania,525628,257881,267747,126065,312004,87559,513269,470536,22545,431,10583,53,9121,12359,448410,77218,355341,53359,130364,82186,89432,501023,24605,14264,69510,455871,325615,175949,92123,57543,2016
42091,Montgomery County, Pennsylvania,799565,389050,410515,175945,488829,134791,777854,640108,67395,1090,59919,295,9047,21711,678208,121357,564047,29657,132847,125767,275776,712588,86977,52599,83066,716229,508813,290013,134214,84586,2016
42101,Philadelphia County, Pennsylvania,1523651,720625,803026,339120,990424,194107,1473277,609987,647485,5219,106558,436,103592,50374,1153723,369928,1044826,172554,330674,240594,301004,1294871,228780,111446,244436,1278753,1026629,474097,235353,317179,2016
44007,Providence County, Rhode Island,608297,296199,312098,130299,389603,88395,584790,441977,56374,4622,24724,572,56521,23507,486772,121525,422601,60060,126790,109678,126073,490076,118221,63179,88622,519551,405150,201662,104881,98607,2016
47037,Davidson County, Tennessee,664028,319694,344334,143602,443540,76886,648399,430140,180556,1398,24941,605,10759,15629,494645,169383,464372,56599,103061,118373,186339,581990,82038,24175,83385,580232,456462,261601,112889,81972,2016
47157,Shelby County, Tennessee,915486,433064,482422,232107,568935,114444,897621,354048,487451,2661,22759,165,30537,17865,748577,166909,599807,67453,153764,191564,187026,858705,56781,20843,113440,800965,595292,303133,138722,153437,2016
48029,Bexar County, Texas,1895930,929296,966634,495151,1179944,220835,1842318,1499675,146793,13972,54461,1273,126144,53612,1619830,276100,1212583,207414,306361,358198,340610,1636660,259270,104001,271114,1613974,1234252,637645,292967,303640,2016
48085,Collin County, Texas,935794,459920,475874,249610,589388,96796,905766,659012,87357,3583,132253,822,22739,30028,831963,103831,611279,39807,91741,162940,316791,750164,185630,92966,60973,874359,617904,359746,130910,127248,2016
48113,Dallas County, Texas,2546156,1250341,1295815,681593,1609889,254674,2470590,1573380,573922,6409,156696,1393,158790,75566,2134963,411193,1621993,351415,353622,419869,497087,1918909,627247,180830,238208,2307547,1679647,935128,367328,377191,2016
48121,Denton County, Texas,792031,389535,402496,202959,514789,74283,760426,590202,71600,3874,62679,602,31469,31605,675289,116742,520480,39551,91937,156162,232830,676844,115187,56034,62319,729390,538521,313708,130733,94080,2016
48141,El Paso County, Texas,822857,399234,423623,230240,494488,98129,802284,667217,27957,5013,10758,299,91040,20573,736545,86312,503399,115820,116048,160019,111512,615744,207113,91331,123737,685782,521665,238973,134185,148507,2016
48157,Fort Bend County, Texas,735455,359400,376055,204051,455107,76297,719635,385543,150146,3077,146796,93,33980,15820,683211,52244,470159,41659,88215,126910,213375,529264,206191,110317,52925,682161,479617,243651,119230,116736,2016
48201,Harris County, Texas,4543604,2255790,2287814,1224990,2878115,440499,4438624,2854627,860201,15178,314776,3755,390087,104980,3898873,644731,2893858,545543,679756,766877,901682,3342602,1201002,434758,423422,4118779,3006166,1598657,691940,715569,2016
48215,Hidalgo County, Texas,840303,408768,431535,280818,467501,91984,828081,711280,2198,1953,9403,93,103154,12222,784352,55951,467334,160354,108577,112511,85892,615373,224930,63789,116395,723908,497603,207043,124512,166048,2016
48339,Montgomery County, Texas,551552,273912,277640,146043,336226,69283,538473,476452,30134,3642,15326,358,12561,13079,488335,63217,359255,46349,84552,107871,120483,475616,75936,26094,61743,489757,353875,178559,86698,88618,2016
48439,Tarrant County, Texas,1992012,973319,1018693,534889,1245438,211685,1927177,1350784,315958,9195,108253,2508,140479,64835,1728197,263815,1275852,185998,312030,383282,394542,1665251,326761,126294,213452,1777371,1306298,709640,311293,285365,2016
48453,Travis County, Texas,1175370,592106,583264,267912,801355,106103,1134618,876801,94156,5197,76035,1397,81032,40752,880043,295327,810147,89583,133738,202530,384296,974131,201239,77893,95365,1079017,827687,491461,198409,137817,2016
49035,Salt Lake County, Utah,1107530,554307,553223,308617,686617,112296,1071328,872799,18920,6481,43146,16812,113170,36202,954756,152774,694731,68994,157703,233007,235027,969527,138003,47990,106783,999137,720275,396711,199301,124263,2016
49049,Utah County, Utah,577259,292436,284823,199764,334004,43491,560723,535066,3190,3892,8044,5236,5295,16536,518270,58989,287877,15491,46331,113902,112153,536129,41130,15008,45500,531167,354561,154655,130974,68932,2016
51059,Fairfax County, Virginia,1127062,559854,567208,267161,720144,139757,1079842,698910,108807,2406,216634,979,52106,47220,973996,153066,770087,62379,92443,143875,471390,772477,354585,193742,80156,1037246,751186,432072,186468,132646,2016
53033,King County, Washington,2121364,1061594,1059770,439112,1414736,267516,1985609,1376918,128839,10527,356242,16457,96626,135755,1642093,479271,1516413,116359,227229,390354,782471,1637165,484199,229988,205912,1914232,1461903,796677,409469,255757,2016
53053,Pierce County, Washington,846011,418814,427197,201901,531195,112915,776247,619478,54137,10456,51672,12135,28369,69764,699277,146734,569822,51866,153271,210406,154279,767128,78883,43940,112367,723791,553129,279687,139968,133474,2016
53061,Snohomish County, Washington,776892,387157,389735,177352,500261,99279,732975,591273,23118,7595,80066,4176,26747,43917,649853,127039,536438,41391,130351,195313,169383,655587,121305,66477,98031,676465,521585,275621,141976,103988,2016
55025,Dane County, Wisconsin,517108,255736,261372,109476,341611,66021,500408,432571,24352,2024,29997,243,11221,16700,379443,137665,343643,12443,60403,91039,179758,468534,48574,20287,43756,472982,353487,199192,114830,39465,2016
55079,Milwaukee County, Wisconsin,930552,449594,480958,228756,584921,116875,895132,548228,244818,4823,39412,168,57683,35420,710167,220385,619178,72991,175115,179963,191109,846340,84212,34675,121315,808772,610346,309146,167416,133784,2016
